GCTGCCCGTGGACACGCTC -> CTGCCCGTGGACACGCTCA
CTGCCCGTGGACACGCTCA -> TGCCCGTGGACACGCTCAG
AGAATCGTAAACCTAACGC -> GAATCGTAAACCTAACGCG
GAATCGTAAACCTAACGCG -> AATCGTAAACCTAACGCGT
AGCCGTTCGGTGTGTCTTT -> GCCGTTCGGTGTGTCTTTT
GCCGTTCGGTGTGTCTTTT -> CCGTTCGGTGTGTCTTTTC
GAGCTACTGGTCGCGGCGA -> AGCTACTGGTCGCGGCGAG
AGCTACTGGTCGCGGCGAG -> GCTACTGGTCGCGGCGAGA
AGGGCCCAAAAAGTAGTGC -> GGGCCCAAAAAGTAGTGCG
GGGCCCAAAAAGTAGTGCG -> GGCCCAAAAAGTAGTGCGT
CTTTGGAAGCCATATGTAA -> TTTGGAAGCCATATGTAAA
TTTGGAAGCCATATGTAAA -> TTGGAAGCCATATGTAAAC
CCCAACAAAGTGTTAGCCC -> CCAACAAAGTGTTAGCCCA
CCAACAAAGTGTTAGCCCA -> CAACAAAGTGTTAGCCCAA
TGTAGAGGAGAAAGATACA -> GTAGAGGAGAAAGATACAT
GTAGAGGAGAAAGATACAT -> TAGAGGAGAAAGATACATA
CTTCATACACGAGTCAAGT -> TTCATACACGAGTCAAGTA
TTCATACACGAGTCAAGTA -> TCATACACGAGTCAAGTAC
ATTCTAGCCACGTCAGTCA -> TTCTAGCCACGTCAGTCAC
TTCTAGCCACGTCAGTCAC -> TCTAGCCACGTCAGTCACA
GAATTTAAGACTTAGGGCT -> AATTTAAGACTTAGGGCTT
AATTTAAGACTTAGGGCTT -> ATTTAAGACTTAGGGCTTC
GTTCGGTGTGTCTTTTCTG -> TTCGGTGTGTCTTTTCTGT
TTCGGTGTGTCTTTTCTGT -> TCGGTGTGTCTTTTCTGTA
CGTGACCCTCACCTGAGCA -> GTGACCCTCACCTGAGCAA
GTGACCCTCACCTGAGCAA -> TGACCCTCACCTGAGCAAT
TTATTCAAGCGAATATAAG -> TATTCAAGCGAATATAAGA
TATTCAAGCGAATATAAGA -> ATTCAAGCGAATATAAGAT
GCGGCCCCCGCGCAATGGG -> CGGCCCCCGCGCAATGGGA
CGGCCCCCGCGCAATGGGA -> GGCCCCCGCGCAATGGGAC
ATAATGACGGCTTCTAAGG -> TAATGACGGCTTCTAAGGT
TAATGACGGCTTCTAAGGT -> AATGACGGCTTCTAAGGTG
TCGTCATGGAGCACGGAAT -> CGTCATGGAGCACGGAATC
CGTCATGGAGCACGGAATC -> GTCATGGAGCACGGAATCT
CGCACGGCTTCTAAATAGG -> GCACGGCTTCTAAATAGGA
GCACGGCTTCTAAATAGGA -> CACGGCTTCTAAATAGGAT
CGGGAGCTACTGGTCGCGG -> GGGAGCTACTGGTCGCGGC
GGGAGCTACTGGTCGCGGC -> GGAGCTACTGGTCGCGGCG
AATGCGAACCCTGACTAGC -> ATGCGAACCCTGACTAGCG
ATGCGAACCCTGACTAGCG -> TGCGAACCCTGACTAGCGG
TGATTCTAGCCACGTCAGT -> GATTCTAGCCACGTCAGTC
GATTCTAGCCACGTCAGTC -> ATTCTAGCCACGTCAGTCA
ACTAATTTATATATCCATT -> CTAATTTATATATCCATTA
CTAATTTATATATCCATTA -> TAATTTATATATCCATTAA
TGGGACGATGCTGCCATGT -> GGGACGATGCTGCCATGTT
GGGACGATGCTGCCATGTT -> GGACGATGCTGCCATGTTG
GCGCTCCCGCGGCATCTAC -> CGCTCCCGCGGCATCTACA
CGCTCCCGCGGCATCTACA -> GCTCCCGCGGCATCTACAT
GCGGCAACGGGGAGAATTA -> CGGCAACGGGGAGAATTAA
CGGCAACGGGGAGAATTAA -> GGCAACGGGGAGAATTAAC
TGGGTAGACAGGCGTAAAA -> GGGTAGACAGGCGTAAAAT
GGGTAGACAGGCGTAAAAT -> GGTAGACAGGCGTAAAATG
ATTCTAGTTGGGTCTTGCA -> TTCTAGTTGGGTCTTGCAC
TTCTAGTTGGGTCTTGCAC -> TCTAGTTGGGTCTTGCACC
ACTTTGGAAGCCATATGTG -> CTTTGGAAGCCATATGTGC
CTTTGGAAGCCATATGTGC -> TTTGGAAGCCATATGTGCA
AAGCGAATATAAGATTGCG -> AGCGAATATAAGATTGCGT
AGCGAATATAAGATTGCGT -> GCGAATATAAGATTGCGTT
CATGGAGCACGGAATCTCT -> ATGGAGCACGGAATCTCTG
ATGGAGCACGGAATCTCTG -> TGGAGCACGGAATCTCTGA
AGGCGCGCCTCGTAGATGC -> GGCGCGCCTCGTAGATGCC
GGCGCGCCTCGTAGATGCC -> GCGCGCCTCGTAGATGCCA
ATACCATAATGATTCCCCC -> TACCATAATGATTCCCCCT
TACCATAATGATTCCCCCT -> ACCATAATGATTCCCCCTT
CCAGACCATAGTATGCTTA -> CAGACCATAGTATGCTTAT
CAGACCATAGTATGCTTAT -> AGACCATAGTATGCTTATT
GGCATTCCGGGAGCTACTG -> GCATTCCGGGAGCTACTGG
GCATTCCGGGAGCTACTGG -> CATTCCGGGAGCTACTGGT
CGACCAGTAGCGAGCGCAT -> GACCAGTAGCGAGCGCATG
GACCAGTAGCGAGCGCATG -> ACCAGTAGCGAGCGCATGG
GCTGATGATCCGGTAACCC -> CTGATGATCCGGTAACCCG
CTGATGATCCGGTAACCCG -> TGATGATCCGGTAACCCGA
GGTGAGGGCTCTCCCCTGG -> GTGAGGGCTCTCCCCTGGT
GTGAGGGCTCTCCCCTGGT -> TGAGGGCTCTCCCCTGGTC
GCGCCGCAATTATGATAAA -> CGCCGCAATTATGATAAAT
CGCCGCAATTATGATAAAT -> GCCGCAATTATGATAAATC
AGCCATATGTCGAATGAGA -> GCCATATGTCGAATGAGAG
GCCATATGTCGAATGAGAG -> CCATATGTCGAATGAGAGG
AAGCTTACAAGAGTCAGCG -> AGCTTACAAGAGTCAGCGG
AGCTTACAAGAGTCAGCGG -> GCTTACAAGAGTCAGCGGC
TTGGCGCCGCACGGCTTCT -> TGGCGCCGCACGGCTTCTA
TGGCGCCGCACGGCTTCTA -> GGCGCCGCACGGCTTCTAA
CCGTTCGGTGTGTCTTTTC -> CGTTCGGTGTGTCTTTTCT
CGTTCGGTGTGTCTTTTCT -> GTTCGGTGTGTCTTTTCTG
TTCTCCCAACAAAGTGTTA -> TCTCCCAACAAAGTGTTAG
TCTCCCAACAAAGTGTTAG -> CTCCCAACAAAGTGTTAGC
GCTCCCGCGGCATCTACAT -> CTCCCGCGGCATCTACATA
GGTCATCGCACAAATCATA -> GTCATCGCACAAATCATAT
GTCATCGCACAAATCATAT -> TCATCGCACAAATCATATG
TTCTAAGGTGAGGGCTCTC -> TCTAAGGTGAGGGCTCTCC
TCTAAGGTGAGGGCTCTCC -> CTAAGGTGAGGGCTCTCCC
ATCATGCAAGCTATAGAAC -> TCATGCAAGCTATAGAACG
TCATGCAAGCTATAGAACG -> CATGCAAGCTATAGAACGT
AAGAATTCAGCGCGCGTGG -> AGAATTCAGCGCGCGTGGC
AGAATTCAGCGCGCGTGGC -> GAATTCAGCGCGCGTGGCC
GTAAATGGTTTAGCGAGCC -> TAAATGGTTTAGCGAGCCC
TAAATGGTTTAGCGAGCCC -> AAATGGTTTAGCGAGCCCT
TTAAAATTGGAGCATTTTA -> TAAAATTGGAGCATTTTAG
TAAAATTGGAGCATTTTAG -> AAAATTGGAGCATTTTAGT
TTACAGTTCTCCCAACAAA -> TACAGTTCTCCCAACAAAG
TACAGTTCTCCCAACAAAG -> ACAGTTCTCCCAACAAAGT
TACTACTGAGCGATGGGAC -> ACTACTGAGCGATGGGACA
ACTACTGAGCGATGGGACA -> CTACTGAGCGATGGGACAG
TGAAAGCTTTGATAACTTT -> GAAAGCTTTGATAACTTTT
GAAAGCTTTGATAACTTTT -> AAAGCTTTGATAACTTTTC
CCGGCCCGATTCCCGGTAC -> CGGCCCGATTCCCGGTACT
CGGCCCGATTCCCGGTACT -> GGCCCGATTCCCGGTACTT
TCCTCACATCCCTAGTAAA -> CCTCACATCCCTAGTAAAA
CCTCACATCCCTAGTAAAA -> CTCACATCCCTAGTAAAAG
TTGGAAGCCATATGTGCAC -> TGGAAGCCATATGTGCACT
TGGAAGCCATATGTGCACT -> GGAAGCCATATGTGCACTG
CATGTTGTGGGCAAGACTG -> ATGTTGTGGGCAAGACTGA
ATGTTGTGGGCAAGACTGA -> TGTTGTGGGCAAGACTGAT
CAGTCACACTATAATGTTA -> AGTCACACTATAATGTTAT
AGTCACACTATAATGTTAT -> GTCACACTATAATGTTATA
TTCTGTAAGATGTAGCGCG -> TCTGTAAGATGTAGCGCGC
TCTGTAAGATGTAGCGCGC -> CTGTAAGATGTAGCGCGCT
GAAGCGCTATAGAATTTAA -> AAGCGCTATAGAATTTAAG
AAGCGCTATAGAATTTAAG -> AGCGCTATAGAATTTAAGA
TGCCCGAGATGTGCACCGT -> GCCCGAGATGTGCACCGTG
GCCCGAGATGTGCACCGTG -> CCCGAGATGTGCACCGTGA
GTCATGGAGCACGGAATCT -> TCATGGAGCACGGAATCTC
GCCCAACGAGCCGGCGATC -> CCCAACGAGCCGGCGATCA
CCCAACGAGCCGGCGATCA -> CCAACGAGCCGGCGATCAT
ACACTTGTCCTTTCAACGT -> CACTTGTCCTTTCAACGTC
CACTTGTCCTTTCAACGTC -> ACTTGTCCTTTCAACGTCT
CTCGGCACGAGTTAAGCAC -> TCGGCACGAGTTAAGCACA
TCGGCACGAGTTAAGCACA -> CGGCACGAGTTAAGCACAA
TTCAACGTCTCGTAAATGG -> TCAACGTCTCGTAAATGGT
TCAACGTCTCGTAAATGGT -> CAACGTCTCGTAAATGGTT
TAAGCCTTCATACACGAGT -> AAGCCTTCATACACGAGTC
AAGCCTTCATACACGAGTC -> AGCCTTCATACACGAGTCA
CTCGACTCGTGAGTTGTTG -> TCGACTCGTGAGTTGTTGT
TCGACTCGTGAGTTGTTGT -> CGACTCGTGAGTTGTTGTG
AGCGTGCTCAAAGTAGAGC -> GCGTGCTCAAAGTAGAGCT
GCGTGCTCAAAGTAGAGCT -> CGTGCTCAAAGTAGAGCTA
GTTCGTAAACTGATTCTAG -> TTCGTAAACTGATTCTAGC
TTCGTAAACTGATTCTAGC -> TCGTAAACTGATTCTAGCC
GAGAGGACGTCTCATGGGG -> AGAGGACGTCTCATGGGGA
AGAGGACGTCTCATGGGGA -> GAGGACGTCTCATGGGGAC
AATTAAAATTGGAGCATTT -> ATTAAAATTGGAGCATTTT
ATTAAAATTGGAGCATTTT -> TTAAAATTGGAGCATTTTA
TCAACAGCGTTGATTTACA -> CAACAGCGTTGATTTACAG
CAACAGCGTTGATTTACAG -> AACAGCGTTGATTTACAGT
GCCTTAAGGAATTTCCGTA -> CCTTAAGGAATTTCCGTAA
CCTTAAGGAATTTCCGTAA -> CTTAAGGAATTTCCGTAAT
CGCCAGATCGTCATGGAGC -> GCCAGATCGTCATGGAGCA
GCCAGATCGTCATGGAGCA -> CCAGATCGTCATGGAGCAC
AGTTGTAGATATAGCGAAA -> GTTGTAGATATAGCGAAAC
GTTGTAGATATAGCGAAAC -> TTGTAGATATAGCGAAACC
AGCGCGAAACCCAGACCAT -> GCGCGAAACCCAGACCATA
GCGCGAAACCCAGACCATA -> CGCGAAACCCAGACCATAG
GAGTTGTTGTGCTGATGAT -> AGTTGTTGTGCTGATGATC
AGTTGTTGTGCTGATGATC -> GTTGTTGTGCTGATGATCC
TCATGGGGACTCCCTTCAG -> CATGGGGACTCCCTTCAGG
CATGGGGACTCCCTTCAGG -> ATGGGGACTCCCTTCAGGG
GGGACTTGCTTTAGAATCG -> GGACTTGCTTTAGAATCGT
GGACTTGCTTTAGAATCGT -> GACTTGCTTTAGAATCGTA
TTAGCCCAACGAGCCGGCG -> TAGCCCAACGAGCCGGCGA
TAGCCCAACGAGCCGGCGA -> AGCCCAACGAGCCGGCGAT
CGCTCTCGACTCGTGAGTT -> GCTCTCGACTCGTGAGTTG
GCTCTCGACTCGTGAGTTG -> CTCTCGACTCGTGAGTTGT
CTCTGGGACTGGCGTTGAG -> TCTGGGACTGGCGTTGAGC
TCTGGGACTGGCGTTGAGC -> CTGGGACTGGCGTTGAGCC
TCTCGTGAAAGCTTTGATA -> CTCGTGAAAGCTTTGATAA
CTCGTGAAAGCTTTGATAA -> TCGTGAAAGCTTTGATAAC
CCTCGAGAGGACGTCTCAT -> CTCGAGAGGACGTCTCATG
CTCGAGAGGACGTCTCATG -> TCGAGAGGACGTCTCATGG
TTCGGTGCTGCGACTTGAT -> TCGGTGCTGCGACTTGATG
TCGGTGCTGCGACTTGATG -> CGGTGCTGCGACTTGATGC
GTGAGTTGTTGTGCTGATG -> TGAGTTGTTGTGCTGATGA
TGAGTTGTTGTGCTGATGA -> GAGTTGTTGTGCTGATGAT
GTGGTGACCGCGATACCAT -> TGGTGACCGCGATACCATA
TGGTGACCGCGATACCATA -> GGTGACCGCGATACCATAA
AGACTGATTGGCCTCGGGG -> GACTGATTGGCCTCGGGGG
GACTGATTGGCCTCGGGGG -> ACTGATTGGCCTCGGGGGA
GCTTTTATTTCCACAGAGG -> CTTTTATTTCCACAGAGGC
CTTTTATTTCCACAGAGGC -> TTTTATTTCCACAGAGGCT
CCACCGCGAGATAGGGGGA -> CACCGCGAGATAGGGGGAC
CACCGCGAGATAGGGGGAC -> ACCGCGAGATAGGGGGACT
TATAATTAAAATTGGAGCA -> ATAATTAAAATTGGAGCAT
ATAATTAAAATTGGAGCAT -> TAATTAAAATTGGAGCATT
GCAGCAGGAAGCGCTATAG -> CAGCAGGAAGCGCTATAGA
CAGCAGGAAGCGCTATAGA -> AGCAGGAAGCGCTATAGAA
GCGAATATAAGATTGCGTT -> CGAATATAAGATTGCGTTG
GAAATGTCATCGTGGTCCT -> AAATGTCATCGTGGTCCTC
AAATGTCATCGTGGTCCTC -> AATGTCATCGTGGTCCTCA
GCCATATGTAAACCTGCGG -> CCATATGTAAACCTGCGGA
CCATATGTAAACCTGCGGA -> CATATGTAAACCTGCGGAA
TTGCGCCGCAATTATGATA -> TGCGCCGCAATTATGATAA
TGCGCCGCAATTATGATAA -> GCGCCGCAATTATGATAAA
GGTGACCGCGATACCATAA -> GTGACCGCGATACCATAAT
GTGACCGCGATACCATAAT -> TGACCGCGATACCATAATG
ATACTAATTTCCTCTGGGA -> TACTAATTTCCTCTGGGAC
TACTAATTTCCTCTGGGAC -> ACTAATTTCCTCTGGGACT
CCCGAAATGTCATCGTGGT -> CCGAAATGTCATCGTGGTC
CCGAAATGTCATCGTGGTC -> CGAAATGTCATCGTGGTCC
ACTAGCCAGCTGCCCGTGG -> CTAGCCAGCTGCCCGTGGA
CTAGCCAGCTGCCCGTGGA -> TAGCCAGCTGCCCGTGGAC
CAACTCTCGTGAAAGCTTT -> AACTCTCGTGAAAGCTTTG
AACTCTCGTGAAAGCTTTG -> ACTCTCGTGAAAGCTTTGA
TTAAGGAATTTCCGTAATC -> TAAGGAATTTCCGTAATCT
TAAGGAATTTCCGTAATCT -> AAGGAATTTCCGTAATCTG
TGAGTTACTACTGAGCGAT -> GAGTTACTACTGAGCGATG
GAGTTACTACTGAGCGATG -> AGTTACTACTGAGCGATGG
CATAGTATGCTTATTCAAG -> ATAGTATGCTTATTCAAGC
ATAGTATGCTTATTCAAGC -> TAGTATGCTTATTCAAGCG
TATAGAACGTTTCGGTGCT -> ATAGAACGTTTCGGTGCTG
ATAGAACGTTTCGGTGCTG -> TAGAACGTTTCGGTGCTGC
ACACTAAAGTGGCAGCAGG -> CACTAAAGTGGCAGCAGGA
CACTAAAGTGGCAGCAGGA -> ACTAAAGTGGCAGCAGGAA
TGTCGAATGAGAGGAGAAT -> GTCGAATGAGAGGAGAATC
GTCGAATGAGAGGAGAATC -> TCGAATGAGAGGAGAATCC
AAGCACAAGAGTACTAAGA -> AGCACAAGAGTACTAAGAA
AGCACAAGAGTACTAAGAA -> GCACAAGAGTACTAAGAAT
AACACTAGGGTAACCAAAC -> ACACTAGGGTAACCAAACG
ACACTAGGGTAACCAAACG -> CACTAGGGTAACCAAACGG
CCTTCAGGGCCCAAAAAGT -> CTTCAGGGCCCAAAAAGTA
CTTCAGGGCCCAAAAAGTA -> TTCAGGGCCCAAAAAGTAG
GCTTTGACACGGGTACTTT -> CTTTGACACGGGTACTTTG
CTTTGACACGGGTACTTTG -> TTTGACACGGGTACTTTGG
TCTTGGCAGACCACTCTCC -> CTTGGCAGACCACTCTCCG
CTTGGCAGACCACTCTCCG -> TTGGCAGACCACTCTCCGG
TGAGGGCTCTCCCCTGGTC -> GAGGGCTCTCCCCTGGTCC
GAGGGCTCTCCCCTGGTCC -> AGGGCTCTCCCCTGGTCCC
GCGTTGCTCTAGGGGGTTT -> CGTTGCTCTAGGGGGTTTT
CGTTGCTCTAGGGGGTTTT -> GTTGCTCTAGGGGGTTTTT
AAACTTAGCCCAACGAGCC -> AACTTAGCCCAACGAGCCG
AACTTAGCCCAACGAGCCG -> ACTTAGCCCAACGAGCCGG
AAAGATACATAACGGGCTG -> AAGATACATAACGGGCTGT
AAGATACATAACGGGCTGT -> AGATACATAACGGGCTGTG
TCTAGCCACGTCAGTCACA -> CTAGCCACGTCAGTCACAC
CTAGCCACGTCAGTCACAC -> TAGCCACGTCAGTCACACT
GAATCCCGTCCGACGAGGG -> AATCCCGTCCGACGAGGGA
AATCCCGTCCGACGAGGGA -> ATCCCGTCCGACGAGGGAA
TAAAACTTAGCCCAACGAG -> AAAACTTAGCCCAACGAGC
AAAACTTAGCCCAACGAGC -> AAACTTAGCCCAACGAGCC
TGCTCAAAGTAGAGCTATA -> GCTCAAAGTAGAGCTATAT
GCTCAAAGTAGAGCTATAT -> CTCAAAGTAGAGCTATATA
AACAGCGTTGATTTACAGT -> ACAGCGTTGATTTACAGTT
ACAGCGTTGATTTACAGTT -> CAGCGTTGATTTACAGTTC
GAGCGCATGGCAACTCTCG -> AGCGCATGGCAACTCTCGT
AGCGCATGGCAACTCTCGT -> GCGCATGGCAACTCTCGTG
AGCCGGCCCGATTCCCGGT -> GCCGGCCCGATTCCCGGTA
GCCGGCCCGATTCCCGGTA -> CCGGCCCGATTCCCGGTAC
CCCGTGGACACGCTCAGAC -> CCGTGGACACGCTCAGACA
CCGTGGACACGCTCAGACA -> CGTGGACACGCTCAGACAT
ACGGAATCTCTGATCCCAC -> CGGAATCTCTGATCCCACC
CGGAATCTCTGATCCCACC -> GGAATCTCTGATCCCACCC
TTAAGACTTAGGGCTTCCA -> TAAGACTTAGGGCTTCCAA
TAAGACTTAGGGCTTCCAA -> AAGACTTAGGGCTTCCAAG
TACTGGTCGCGGCGAGAAA -> ACTGGTCGCGGCGAGAAAG
ACTGGTCGCGGCGAGAAAG -> CTGGTCGCGGCGAGAAAGG
TGACCCTCACCTGAGCAAT -> GACCCTCACCTGAGCAATC
GACCCTCACCTGAGCAATC -> ACCCTCACCTGAGCAATCG
AAAATTGGAGCATTTTAGT -> AAATTGGAGCATTTTAGTT
AAATTGGAGCATTTTAGTT -> AATTGGAGCATTTTAGTTG
ATGTAAACCTGCGGAACTA -> TGTAAACCTGCGGAACTAG
TGTAAACCTGCGGAACTAG -> GTAAACCTGCGGAACTAGC
GGTGCTGCGACTTGATGCT -> GTGCTGCGACTTGATGCTC
GTGCTGCGACTTGATGCTC -> TGCTGCGACTTGATGCTCT
AGCCCAACGAGCCGGCGAT -> GCCCAACGAGCCGGCGATC
GTATTTGATACTTTGGAAG -> TATTTGATACTTTGGAAGC
TATTTGATACTTTGGAAGC -> ATTTGATACTTTGGAAGCC
TCGAATGAGAGGAGAATCC -> CGAATGAGAGGAGAATCCC
CAATGGGACGATGCTGCCA -> AATGGGACGATGCTGCCAT
AATGGGACGATGCTGCCAT -> ATGGGACGATGCTGCCATG
TCATGGAGCACGGAATCTC -> CATGGAGCACGGAATCTCT
GCGCGCCTCGTAGATGCCA -> CGCGCCTCGTAGATGCCAT
CCATAATGATTCCCCCTTA -> CATAATGATTCCCCCTTAG
CATAATGATTCCCCCTTAG -> ATAATGATTCCCCCTTAGC
TAAGATTGCGTTGGCGCCG -> AAGATTGCGTTGGCGCCGC
AAGATTGCGTTGGCGCCGC -> AGATTGCGTTGGCGCCGCA
TCCCCTCTGTTCTTGTCTC -> CCCCTCTGTTCTTGTCTCG
CCCCTCTGTTCTTGTCTCG -> CCCTCTGTTCTTGTCTCGT
CTCAGACATGACACGAAGA -> TCAGACATGACACGAAGAC
TCAGACATGACACGAAGAC -> CAGACATGACACGAAGACC
GGAAACAGCTCCACACTGT -> GAAACAGCTCCACACTGTC
GAAACAGCTCCACACTGTC -> AAACAGCTCCACACTGTCT
CTGGCGTTGAGCCGTAGGT -> TGGCGTTGAGCCGTAGGTA
TGGCGTTGAGCCGTAGGTA -> GGCGTTGAGCCGTAGGTAT
GTTAGCCCAACGAGCCGGC -> TTAGCCCAACGAGCCGGCG
TCAAAGTAGAGCTATATAG -> CAAAGTAGAGCTATATAGG
CAAAGTAGAGCTATATAGG -> AAAGTAGAGCTATATAGGG
ACAGCTCCACACTGTCTAA -> CAGCTCCACACTGTCTAAT
CAGCTCCACACTGTCTAAT -> AGCTCCACACTGTCTAATT
CGCAACAGTTGTCACACCG -> GCAACAGTTGTCACACCGT
GCAACAGTTGTCACACCGT -> CAACAGTTGTCACACCGTT
GCCGGCGATCATTCAGCTA -> CCGGCGATCATTCAGCTAC
CCGGCGATCATTCAGCTAC -> CGGCGATCATTCAGCTACT
GATAAATCCCCTCGAGAGG -> ATAAATCCCCTCGAGAGGA
ATAAATCCCCTCGAGAGGA -> TAAATCCCCTCGAGAGGAC
TAGCGACCAGTAGCGAGCG -> AGCGACCAGTAGCGAGCGC
AGCGACCAGTAGCGAGCGC -> GCGACCAGTAGCGAGCGCA
CTCACCGCCAGATCGTCAT -> TCACCGCCAGATCGTCATG
TCACCGCCAGATCGTCATG -> CACCGCCAGATCGTCATGG
GTAACCCGAGACTAGAGCG -> TAACCCGAGACTAGAGCGT
TAACCCGAGACTAGAGCGT -> AACCCGAGACTAGAGCGTA
GAGCGTAATACCCCACTTC -> AGCGTAATACCCCACTTCG
AGCGTAATACCCCACTTCG -> GCGTAATACCCCACTTCGG
AAATGGTTTAGCGAGCCCT -> AATGGTTTAGCGAGCCCTT
AATGGTTTAGCGAGCCCTT -> ATGGTTTAGCGAGCCCTTC
TGCTTATTCAAGCGAATAT -> GCTTATTCAAGCGAATATA
GCTTATTCAAGCGAATATA -> CTTATTCAAGCGAATATAA
GCACGAGTTAAGCACAAGA -> CACGAGTTAAGCACAAGAG
CACGAGTTAAGCACAAGAG -> ACGAGTTAAGCACAAGAGT
AGAGCGTAATACCCCACTT -> GAGCGTAATACCCCACTTC
CAACGAGCCGGCCCGATTC -> AACGAGCCGGCCCGATTCC
AACGAGCCGGCCCGATTCC -> ACGAGCCGGCCCGATTCCC
GTAATGTACGTAGAGGTGA -> TAATGTACGTAGAGGTGAG
TAATGTACGTAGAGGTGAG -> AATGTACGTAGAGGTGAGC
CACGAAGACCAGTTGCGTT -> ACGAAGACCAGTTGCGTTG
ACGAAGACCAGTTGCGTTG -> CGAAGACCAGTTGCGTTGC
CGAAACCCAGACCATAGTA -> GAAACCCAGACCATAGTAT
GAAACCCAGACCATAGTAT -> AAACCCAGACCATAGTATG
AGTTCTCCCAACAAAGTGT -> GTTCTCCCAACAAAGTGTT
GTTCTCCCAACAAAGTGTT -> TTCTCCCAACAAAGTGTTA
AGCGCAGTCCAACATTGAA -> GCGCAGTCCAACATTGAAG
GCGCAGTCCAACATTGAAG -> CGCAGTCCAACATTGAAGG
AGTGTTAGCCCAACGAGCC -> GTGTTAGCCCAACGAGCCG
GTGTTAGCCCAACGAGCCG -> TGTTAGCCCAACGAGCCGG
AGGTGAGGGCTCTCCCCTG -> GGTGAGGGCTCTCCCCTGG
GCCCAACGAGCCGGCCCGA -> CCCAACGAGCCGGCCCGAT
CCCAACGAGCCGGCCCGAT -> CCAACGAGCCGGCCCGATT
TCTTGCACCATTTAGCCCA -> CTTGCACCATTTAGCCCAA
CTTGCACCATTTAGCCCAA -> TTGCACCATTTAGCCCAAC
TCCGTCGTAATTTAGTTTG -> CCGTCGTAATTTAGTTTGC
CCGTCGTAATTTAGTTTGC -> CGTCGTAATTTAGTTTGCG
TGTCATCGTGGTCCTCACA -> GTCATCGTGGTCCTCACAT
GTCATCGTGGTCCTCACAT -> TCATCGTGGTCCTCACATC
CCAACGAGCCGGCGATCAT -> CAACGAGCCGGCGATCATT
CAACGAGCCGGCGATCATT -> AACGAGCCGGCGATCATTC
CAGCTGCCCGTGGACACGC -> AGCTGCCCGTGGACACGCT
AGCTGCCCGTGGACACGCT -> GCTGCCCGTGGACACGCTC
TTCGCATACTAATTTCCTC -> TCGCATACTAATTTCCTCT
TCGCATACTAATTTCCTCT -> CGCATACTAATTTCCTCTG
AGCTATATAGGGCTTTTAT -> GCTATATAGGGCTTTTATT
GCTATATAGGGCTTTTATT -> CTATATAGGGCTTTTATTT
ACACTAATTTATATATCCA -> CACTAATTTATATATCCAT
CACTAATTTATATATCCAT -> ACTAATTTATATATCCATT
CGGAACTAGCCAGCTGCCC -> GGAACTAGCCAGCTGCCCG
GGAACTAGCCAGCTGCCCG -> GAACTAGCCAGCTGCCCGT
CGTGGTGACCGCGATACCA -> GTGGTGACCGCGATACCAT
TAGTTGGGTCTTGCACCAT -> AGTTGGGTCTTGCACCATT
AGTTGGGTCTTGCACCATT -> GTTGGGTCTTGCACCATTT
CCTGGTCCCGCTCGGCACG -> CTGGTCCCGCTCGGCACGA
CTGGTCCCGCTCGGCACGA -> TGGTCCCGCTCGGCACGAG
ATTGGCCTCGGGGGACGAA -> TTGGCCTCGGGGGACGAAG
TTGGCCTCGGGGGACGAAG -> TGGCCTCGGGGGACGAAGG
GGTGTGTCTTTTCTGTAAG -> GTGTGTCTTTTCTGTAAGA
GTGTGTCTTTTCTGTAAGA -> TGTGTCTTTTCTGTAAGAT
GTCTCGGCATTCCGGGAGC -> TCTCGGCATTCCGGGAGCT
TCTCGGCATTCCGGGAGCT -> CTCGGCATTCCGGGAGCTA
CGTCCGACGAGGGAAGGTT -> GTCCGACGAGGGAAGGTTA
GTCCGACGAGGGAAGGTTA -> TCCGACGAGGGAAGGTTAC
ACCGAAGGTTGGTATTTAG -> CCGAAGGTTGGTATTTAGC
CCGAAGGTTGGTATTTAGC -> CGAAGGTTGGTATTTAGCC
GGCGTAAAATGATATTACT -> GCGTAAAATGATATTACTA
GCGTAAAATGATATTACTA -> CGTAAAATGATATTACTAA
AAGACTGATTGGCCTCGGG -> AGACTGATTGGCCTCGGGG
AAAAGTTCAGCAGTTGTTC -> AAAGTTCAGCAGTTGTTCG
AAAGTTCAGCAGTTGTTCG -> AAGTTCAGCAGTTGTTCGT
ACTGATTCTAGCCACGTCA -> CTGATTCTAGCCACGTCAG
CTGATTCTAGCCACGTCAG -> TGATTCTAGCCACGTCAGT
GGGGACTTGCTTTAGAATC -> GGGACTTGCTTTAGAATCG
ACTCCTTCGTGGAAACAGC -> CTCCTTCGTGGAAACAGCT
CTCCTTCGTGGAAACAGCT -> TCCTTCGTGGAAACAGCTC
TCACATCCCTAGTAAAAGT -> CACATCCCTAGTAAAAGTT
CACATCCCTAGTAAAAGTT -> ACATCCCTAGTAAAAGTTC
TGTGTAGCCCCGCCCCTTC -> GTGTAGCCCCGCCCCTTCG
GTGTAGCCCCGCCCCTTCG -> TGTAGCCCCGCCCCTTCGC
TTTATATATCCATTAAACG -> TTATATATCCATTAAACGG
TTATATATCCATTAAACGG -> TATATATCCATTAAACGGG
CATATGTCGAATGAGAGGA -> ATATGTCGAATGAGAGGAG
ATATGTCGAATGAGAGGAG -> TATGTCGAATGAGAGGAGA
TTGCTTTAGAATCGTAAAC -> TGCTTTAGAATCGTAAACC
TGCTTTAGAATCGTAAACC -> GCTTTAGAATCGTAAACCT
TAAACTGATTCTAGCCACG -> AAACTGATTCTAGCCACGT
AAACTGATTCTAGCCACGT -> AACTGATTCTAGCCACGTC
CAACGAGCCGGCTTTGACA -> AACGAGCCGGCTTTGACAC
AACGAGCCGGCTTTGACAC -> ACGAGCCGGCTTTGACACG
CTGAGCAATCGGCTCTTTA -> TGAGCAATCGGCTCTTTAG
TGAGCAATCGGCTCTTTAG -> GAGCAATCGGCTCTTTAGT
ACACGAGTCAAGTACGTGG -> CACGAGTCAAGTACGTGGG
CACGAGTCAAGTACGTGGG -> ACGAGTCAAGTACGTGGGT
AGACCACTCTCCGGGCGCA -> GACCACTCTCCGGGCGCAA
GACCACTCTCCGGGCGCAA -> ACCACTCTCCGGGCGCAAC
TGTTGTGGGCAAGACTGAT -> GTTGTGGGCAAGACTGATT
GTTGTGGGCAAGACTGATT -> TTGTGGGCAAGACTGATTG
CAACGGGGAGAATTAACAC -> AACGGGGAGAATTAACACT
AACGGGGAGAATTAACACT -> ACGGGGAGAATTAACACTA
CGTGGTCCTCACATCCCTA -> GTGGTCCTCACATCCCTAG
GTGGTCCTCACATCCCTAG -> TGGTCCTCACATCCCTAGT
TCGTCACCACCCGTGCCTC -> CGTCACCACCCGTGCCTCA
CGTCACCACCCGTGCCTCA -> GTCACCACCCGTGCCTCAC
AGGAGAATCCCGTCCGACG -> GGAGAATCCCGTCCGACGA
GGAGAATCCCGTCCGACGA -> GAGAATCCCGTCCGACGAG
CTATAGAACGTTTCGGTGC -> TATAGAACGTTTCGGTGCT
CCGCCCCTTCGCATACTAA -> CGCCCCTTCGCATACTAAT
CGCCCCTTCGCATACTAAT -> GCCCCTTCGCATACTAATT
AACCGAAGGTTGGTATTTA -> ACCGAAGGTTGGTATTTAG
CGGCAGGAAACATGCCATG -> GGCAGGAAACATGCCATGA
GGCAGGAAACATGCCATGA -> GCAGGAAACATGCCATGAC
AGCCACGTCAGTCACACTA -> GCCACGTCAGTCACACTAT
GCCACGTCAGTCACACTAT -> CCACGTCAGTCACACTATA
GCACAAGAGTACTAAGAAT -> CACAAGAGTACTAAGAATT
CACAAGAGTACTAAGAATT -> ACAAGAGTACTAAGAATTC
GATACATAACGGGCTGTGA -> ATACATAACGGGCTGTGAG
ATACATAACGGGCTGTGAG -> TACATAACGGGCTGTGAGC
AAGACTTAGGGCTTCCAAG -> AGACTTAGGGCTTCCAAGG
AGATTGCGTTGGCGCCGCA -> GATTGCGTTGGCGCCGCAC
GGCATCTACATAATGACGG -> GCATCTACATAATGACGGC
GCATCTACATAATGACGGC -> CATCTACATAATGACGGCT
GAGACTAGAGCGTAATACC -> AGACTAGAGCGTAATACCC
AGACTAGAGCGTAATACCC -> GACTAGAGCGTAATACCCC
GGTTACTCGTTGCGGCCCC -> GTTACTCGTTGCGGCCCCC
GTTACTCGTTGCGGCCCCC -> TTACTCGTTGCGGCCCCCT
GTGCACTGTAGCGCGAAAC -> TGCACTGTAGCGCGAAACC
TGCACTGTAGCGCGAAACC -> GCACTGTAGCGCGAAACCC
TTGCACCATTTAGCCCAAC -> TGCACCATTTAGCCCAACG
TACATAATGACGGCTTCTA -> ACATAATGACGGCTTCTAA
ACATAATGACGGCTTCTAA -> CATAATGACGGCTTCTAAG
GGTCTTGCACCATTTAGCC -> GTCTTGCACCATTTAGCCC
GTCTTGCACCATTTAGCCC -> TCTTGCACCATTTAGCCCA
CCGGGAGCTACTGGTCGCG -> CGGGAGCTACTGGTCGCGG
GTGGGCAAGACTGATTGGC -> TGGGCAAGACTGATTGGCC
TGGGCAAGACTGATTGGCC -> GGGCAAGACTGATTGGCCT
GGAAGCCATATGTGCACTG -> GAAGCCATATGTGCACTGT
TTGATACTTTGGAAGCCAT -> TGATACTTTGGAAGCCATA
TGATACTTTGGAAGCCATA -> GATACTTTGGAAGCCATAT
AAGGTGAGGGCTCTCCCCT -> AGGTGAGGGCTCTCCCCTG
AAATACAGAATAAGCCTTC -> AATACAGAATAAGCCTTCA
AATACAGAATAAGCCTTCA -> ATACAGAATAAGCCTTCAT
ATAATGTTATATGGAAACT -> TAATGTTATATGGAAACTA
TAATGTTATATGGAAACTA -> AATGTTATATGGAAACTAC
ACGTAGAGGTGAGCAATGC -> CGTAGAGGTGAGCAATGCG
CGTAGAGGTGAGCAATGCG -> GTAGAGGTGAGCAATGCGA
CACCATTTAGCCCAACGAG -> ACCATTTAGCCCAACGAGC
ACCATTTAGCCCAACGAGC -> CCATTTAGCCCAACGAGCC
ACAGGCGTAAAATGATATT -> CAGGCGTAAAATGATATTA
CAGGCGTAAAATGATATTA -> AGGCGTAAAATGATATTAC
AACGAGCCGGCGATCATTC -> ACGAGCCGGCGATCATTCA
AGAACGTTTCGGTGCTGCG -> GAACGTTTCGGTGCTGCGA
GAACGTTTCGGTGCTGCGA -> AACGTTTCGGTGCTGCGAC
TTGGAGCATTTTAGTTGGT -> TGGAGCATTTTAGTTGGTC
TGGAGCATTTTAGTTGGTC -> GGAGCATTTTAGTTGGTCA
CGAATATAAGATTGCGTTG -> GAATATAAGATTGCGTTGG
GAATATAAGATTGCGTTGG -> AATATAAGATTGCGTTGGC
TCCCCTGGTCCCGCTCGGC -> CCCCTGGTCCCGCTCGGCA
CCCCTGGTCCCGCTCGGCA -> CCCTGGTCCCGCTCGGCAC
AGCTTTGATAACTTTTCCC -> GCTTTGATAACTTTTCCCG
GCTTTGATAACTTTTCCCG -> CTTTGATAACTTTTCCCGT
TATGCTTATTCAAGCGAAT -> ATGCTTATTCAAGCGAATA
ATGCTTATTCAAGCGAATA -> TGCTTATTCAAGCGAATAT
GGGACTCCCTTCAGGGCCC -> GGACTCCCTTCAGGGCCCA
GGACTCCCTTCAGGGCCCA -> GACTCCCTTCAGGGCCCAA
TATGGTAACACTAATTTAT -> ATGGTAACACTAATTTATA
ATGGTAACACTAATTTATA -> TGGTAACACTAATTTATAT
CTTCGGCAAACACTTGTCC -> TTCGGCAAACACTTGTCCT
TTCGGCAAACACTTGTCCT -> TCGGCAAACACTTGTCCTT
CATTCCGGGAGCTACTGGT -> ATTCCGGGAGCTACTGGTC
ATTCCGGGAGCTACTGGTC -> TTCCGGGAGCTACTGGTCG
ATAAGATTGCGTTGGCGCC -> TAAGATTGCGTTGGCGCCG
TGGCAACTCTCGTGAAAGC -> GGCAACTCTCGTGAAAGCT
GGCAACTCTCGTGAAAGCT -> GCAACTCTCGTGAAAGCTT
AAATCATGCAAGCTATAGA -> AATCATGCAAGCTATAGAA
AATCATGCAAGCTATAGAA -> ATCATGCAAGCTATAGAAC
CATCGCACAAATCATATGG -> ATCGCACAAATCATATGGT
ATCGCACAAATCATATGGT -> TCGCACAAATCATATGGTA
AGCGATGGGACAGCCGTTC -> GCGATGGGACAGCCGTTCG
GCGATGGGACAGCCGTTCG -> CGATGGGACAGCCGTTCGG
TTTAGTTTGCGCCGCAATT -> TTAGTTTGCGCCGCAATTA
TTAGTTTGCGCCGCAATTA -> TAGTTTGCGCCGCAATTAT
GCCCCTTCGCATACTAATT -> CCCCTTCGCATACTAATTT
CCCCTTCGCATACTAATTT -> CCCTTCGCATACTAATTTC
GTGAGCGCAGTCCAACATT -> TGAGCGCAGTCCAACATTG
TGAGCGCAGTCCAACATTG -> GAGCGCAGTCCAACATTGA
CTTCGCATACTAATTTCCT -> TTCGCATACTAATTTCCTC
TTGGGTCTTGCACCATTTA -> TGGGTCTTGCACCATTTAG
TGGGTCTTGCACCATTTAG -> GGGTCTTGCACCATTTAGC
GATTGGCCTCGGGGGACGA -> ATTGGCCTCGGGGGACGAA
TATAAGATTGCGTTGGCGC -> ATAAGATTGCGTTGGCGCC
TCTGTGTAGCCCCGCCCCT -> CTGTGTAGCCCCGCCCCTT
CTGTGTAGCCCCGCCCCTT -> TGTGTAGCCCCGCCCCTTC
CCACGTCAGTCACACTATA -> CACGTCAGTCACACTATAA
TAGCGAGCCCTTCCTTCAT -> AGCGAGCCCTTCCTTCATT
AGCGAGCCCTTCCTTCATT -> GCGAGCCCTTCCTTCATTC
CGCTCGGCACGAGTTAAGC -> GCTCGGCACGAGTTAAGCA
GCTCGGCACGAGTTAAGCA -> CTCGGCACGAGTTAAGCAC
ACTTTTCCCGTCCGTCGTA -> CTTTTCCCGTCCGTCGTAA
CTTTTCCCGTCCGTCGTAA -> TTTTCCCGTCCGTCGTAAT
AGAGGAGAATCCCGTCCGA -> GAGGAGAATCCCGTCCGAC
GAGGAGAATCCCGTCCGAC -> AGGAGAATCCCGTCCGACG
GCTCAGACATGACACGAAG -> CTCAGACATGACACGAAGA
TTCCGTAATCTGTGTAGCC -> TCCGTAATCTGTGTAGCCC
TCCGTAATCTGTGTAGCCC -> CCGTAATCTGTGTAGCCCC
TCTCGTAAATGGTTTAGCG -> CTCGTAAATGGTTTAGCGA
CTCGTAAATGGTTTAGCGA -> TCGTAAATGGTTTAGCGAG
TAGCCCAACGAGCCGGCCC -> AGCCCAACGAGCCGGCCCG
AGCCCAACGAGCCGGCCCG -> GCCCAACGAGCCGGCCCGA
TCACACCGTTTCCAGGCCC -> CACACCGTTTCCAGGCCCG
CACACCGTTTCCAGGCCCG -> ACACCGTTTCCAGGCCCGA
ATGGGGACTCCCTTCAGGG -> TGGGGACTCCCTTCAGGGC
GCCCAACGAGCCGGCTTTG -> CCCAACGAGCCGGCTTTGA
CCCAACGAGCCGGCTTTGA -> CCAACGAGCCGGCTTTGAC
GTGGAAACAGCTCCACACT -> TGGAAACAGCTCCACACTG
TGGAAACAGCTCCACACTG -> GGAAACAGCTCCACACTGT
AGTTGTTCGTAAACTGATT -> GTTGTTCGTAAACTGATTC
GTTGTTCGTAAACTGATTC -> TTGTTCGTAAACTGATTCT
CACCGTTTCCAGGCCCGAA -> ACCGTTTCCAGGCCCGAAA
ACCGTTTCCAGGCCCGAAA -> CCGTTTCCAGGCCCGAAAT
CCGGTAACCCGAGACTAGA -> CGGTAACCCGAGACTAGAG
CGGTAACCCGAGACTAGAG -> GGTAACCCGAGACTAGAGC
TAGAGCTATATAGGGCTTT -> AGAGCTATATAGGGCTTTT
AGAGCTATATAGGGCTTTT -> GAGCTATATAGGGCTTTTA
CCATATGTCGAATGAGAGG -> CATATGTCGAATGAGAGGA
ATTTATATATCCATTAAAC -> TTTATATATCCATTAAACG
CCCGAGATGTGCACCGTGA -> CCGAGATGTGCACCGTGAC
GATGATCCGGTAACCCGAG -> ATGATCCGGTAACCCGAGA
ATGATCCGGTAACCCGAGA -> TGATCCGGTAACCCGAGAC
GAGAGGAGAATCCCGTCCG -> AGAGGAGAATCCCGTCCGA
GCGTAATACCCCACTTCGG -> CGTAATACCCCACTTCGGC
TCAGCAGTTGTTCGTAAAC -> CAGCAGTTGTTCGTAAACT
CAGCAGTTGTTCGTAAACT -> AGCAGTTGTTCGTAAACTG
GCGAGCGCATGGCAACTCT -> CGAGCGCATGGCAACTCTC
CGAGCGCATGGCAACTCTC -> GAGCGCATGGCAACTCTCG
CTTCCAAGGAGTAAAACTT -> TTCCAAGGAGTAAAACTTA
TTCCAAGGAGTAAAACTTA -> TCCAAGGAGTAAAACTTAG
ATGATAAATCCCCTCGAGA -> TGATAAATCCCCTCGAGAG
TGATAAATCCCCTCGAGAG -> GATAAATCCCCTCGAGAGG
GATTTACAGTTCTCCCAAC -> ATTTACAGTTCTCCCAACA
ATTTACAGTTCTCCCAACA -> TTTACAGTTCTCCCAACAA
ATTAGCCCAACGAGCCGGC -> TTAGCCCAACGAGCCGGCA
TTAGCCCAACGAGCCGGCA -> TAGCCCAACGAGCCGGCAA
CCGGGCGCAACAGTTGTCA -> CGGGCGCAACAGTTGTCAC
CGGGCGCAACAGTTGTCAC -> GGGCGCAACAGTTGTCACA
GCCCCGCCCCTTCGCATAC -> CCCCGCCCCTTCGCATACT
CCCCGCCCCTTCGCATACT -> CCCGCCCCTTCGCATACTA
AATATAAGATTGCGTTGGC -> ATATAAGATTGCGTTGGCG
ATATGTGCACTGTAGCGCG -> TATGTGCACTGTAGCGCGA
TATGTGCACTGTAGCGCGA -> ATGTGCACTGTAGCGCGAA
TTGGAAGCCATATGTAAAC -> TGGAAGCCATATGTAAACC
TGGAAGCCATATGTAAACC -> GGAAGCCATATGTAAACCT
TGATCCGGTAACCCGAGAC -> GATCCGGTAACCCGAGACT
GATCCGGTAACCCGAGACT -> ATCCGGTAACCCGAGACTA
GAGTACTAAGAATTCAGCG -> AGTACTAAGAATTCAGCGC
AGTACTAAGAATTCAGCGC -> GTACTAAGAATTCAGCGCG
CCGGCAATGTATTTGATAC -> CGGCAATGTATTTGATACT
CGGCAATGTATTTGATACT -> GGCAATGTATTTGATACTT
CGTAAAATGATATTACTAA -> GTAAAATGATATTACTAAC
TGTCACACCGTTTCCAGGC -> GTCACACCGTTTCCAGGCC
GTCACACCGTTTCCAGGCC -> TCACACCGTTTCCAGGCCC
ACTAAAGTGGCAGCAGGAA -> CTAAAGTGGCAGCAGGAAG
CCTCGGGGGACGAAGGCAG -> CTCGGGGGACGAAGGCAGG
CTCGGGGGACGAAGGCAGG -> TCGGGGGACGAAGGCAGGC
TTAGCCCGTAGCGTGCTCA -> TAGCCCGTAGCGTGCTCAA
TAGCCCGTAGCGTGCTCAA -> AGCCCGTAGCGTGCTCAAA
CTACTTTGGAAGCCATATG -> TACTTTGGAAGCCATATGT
TACTTTGGAAGCCATATGT -> ACTTTGGAAGCCATATGTC,ACTTTGGAAGCCATATGTA,ACTTTGGAAGCCATATGTT,ACTTTGGAAGCCATATGTG
CAACAGTTGTCACACCGTT -> AACAGTTGTCACACCGTTT
AACAGTTGTCACACCGTTT -> ACAGTTGTCACACCGTTTC
CACAGAGGCTGGTCGATCA -> ACAGAGGCTGGTCGATCAA
ACAGAGGCTGGTCGATCAA -> CAGAGGCTGGTCGATCAAT
CCGCGCAATGGGACGATGC -> CGCGCAATGGGACGATGCT
CGCGCAATGGGACGATGCT -> GCGCAATGGGACGATGCTG
AATAGGATATGGTGAACTG -> ATAGGATATGGTGAACTGA
ATAGGATATGGTGAACTGA -> TAGGATATGGTGAACTGAG
CCGTCCGACGAGGGAAGGT -> CGTCCGACGAGGGAAGGTT
CCTTCGTGGAAACAGCTCC -> CTTCGTGGAAACAGCTCCA
CTTCGTGGAAACAGCTCCA -> TTCGTGGAAACAGCTCCAC
ACGGGGAGAATTAACACTA -> CGGGGAGAATTAACACTAG
CGGGGAGAATTAACACTAG -> GGGGAGAATTAACACTAGG
ACGAAGGCAGGCGCGCCTC -> CGAAGGCAGGCGCGCCTCG
CGAAGGCAGGCGCGCCTCG -> GAAGGCAGGCGCGCCTCGT
ACTAATTTCCTCTGGGACT -> CTAATTTCCTCTGGGACTG
CTAATTTCCTCTGGGACTG -> TAATTTCCTCTGGGACTGG
ATTAACACTAGGGTAACCA -> TTAACACTAGGGTAACCAA
TTAACACTAGGGTAACCAA -> TAACACTAGGGTAACCAAA
CCGAGATGTGCACCGTGAC -> CGAGATGTGCACCGTGACC
GGCGTTGAGCCGTAGGTAT -> GCGTTGAGCCGTAGGTATG
CTAGCGGCAACGGGGAGAA -> TAGCGGCAACGGGGAGAAT
TAGCGGCAACGGGGAGAAT -> AGCGGCAACGGGGAGAATT
TGCCCTGTAGAGGAGAAAG -> GCCCTGTAGAGGAGAAAGA
GCCCTGTAGAGGAGAAAGA -> CCCTGTAGAGGAGAAAGAT
TGGGACAGCCGTTCGGTGT -> GGGACAGCCGTTCGGTGTG
GGGACAGCCGTTCGGTGTG -> GGACAGCCGTTCGGTGTGT
CGCGAAACCCAGACCATAG -> GCGAAACCCAGACCATAGT
GCGAAACCCAGACCATAGT -> CGAAACCCAGACCATAGTA
GGAGCACGGAATCTCTGAT -> GAGCACGGAATCTCTGATC
GAGCACGGAATCTCTGATC -> AGCACGGAATCTCTGATCC
ACGAGCCGGCAATGTATTT -> CGAGCCGGCAATGTATTTG
CGAGCCGGCAATGTATTTG -> GAGCCGGCAATGTATTTGA
AGCCAGCTGCCCGTGGACA -> GCCAGCTGCCCGTGGACAC
GCCAGCTGCCCGTGGACAC -> CCAGCTGCCCGTGGACACG
AGCAGTTGTTCGTAAACTG -> GCAGTTGTTCGTAAACTGA
GCAGTTGTTCGTAAACTGA -> CAGTTGTTCGTAAACTGAT
ACGTGGGTAGACAGGCGTA -> CGTGGGTAGACAGGCGTAA
CGTGGGTAGACAGGCGTAA -> GTGGGTAGACAGGCGTAAA
GTCGCGGCGAGAAAGGCTG -> TCGCGGCGAGAAAGGCTGT
TCGCGGCGAGAAAGGCTGT -> CGCGGCGAGAAAGGCTGTA
TGAGCGATGGGACAGCCGT -> GAGCGATGGGACAGCCGTT
GAGCGATGGGACAGCCGTT -> AGCGATGGGACAGCCGTTC
CATTTTAGTTGGTCATTCC -> ATTTTAGTTGGTCATTCCT
ATTTTAGTTGGTCATTCCT -> TTTTAGTTGGTCATTCCTG
GTTGATTTACAGTTCTCCC -> TTGATTTACAGTTCTCCCA
TTGATTTACAGTTCTCCCA -> TGATTTACAGTTCTCCCAA
ACCCCACTTCGGCAAACAC -> CCCCACTTCGGCAAACACT
CCCCACTTCGGCAAACACT -> CCCACTTCGGCAAACACTT
TGGAAGCCATATGTCGAAT -> GGAAGCCATATGTCGAATG
GGAAGCCATATGTCGAATG -> GAAGCCATATGTCGAATGA
AGAATTTAAGACTTAGGGC -> GAATTTAAGACTTAGGGCT
GCGTGGCCGCGCTCTCGAC -> CGTGGCCGCGCTCTCGACT
CGTGGCCGCGCTCTCGACT -> GTGGCCGCGCTCTCGACTC
GAGAAAGATACATAACGGG -> AGAAAGATACATAACGGGC
AGAAAGATACATAACGGGC -> GAAAGATACATAACGGGCT
CCCAGACCATAGTATGCTT -> CCAGACCATAGTATGCTTA
CCCGCGCAATGGGACGATG -> CCGCGCAATGGGACGATGC
TAGTTGGTCATTCCTGTCG -> AGTTGGTCATTCCTGTCGC
AGTTGGTCATTCCTGTCGC -> GTTGGTCATTCCTGTCGCT
GGCCCGATTCCCGGTACTT -> GCCCGATTCCCGGTACTTT
GCCCGATTCCCGGTACTTT -> CCCGATTCCCGGTACTTTG
GATATAGCGAAACCGAAGG -> ATATAGCGAAACCGAAGGT
ATATAGCGAAACCGAAGGT -> TATAGCGAAACCGAAGGTT
GTCATTCCTGTCGCTGCCA -> TCATTCCTGTCGCTGCCAG
TCATTCCTGTCGCTGCCAG -> CATTCCTGTCGCTGCCAGG
TTACTCGTTGCGGCCCCCT -> TACTCGTTGCGGCCCCCTC
TATTACTAACGCACGCTCT -> ATTACTAACGCACGCTCTT
ATTACTAACGCACGCTCTT -> TTACTAACGCACGCTCTTT
GGGAAGGTTACTCGTTGCG -> GGAAGGTTACTCGTTGCGG
GGAAGGTTACTCGTTGCGG -> GAAGGTTACTCGTTGCGGC
CTCTACTACGGCAGGAAAC -> TCTACTACGGCAGGAAACA
TCTACTACGGCAGGAAACA -> CTACTACGGCAGGAAACAT
CACTAGGGTAACCAAACGG -> ACTAGGGTAACCAAACGGT
ACTAGGGTAACCAAACGGT -> CTAGGGTAACCAAACGGTC
TCGTAATTTAGTTTGCGCC -> CGTAATTTAGTTTGCGCCG
CGTAATTTAGTTTGCGCCG -> GTAATTTAGTTTGCGCCGC
TAATTTATATATCCATTAA -> AATTTATATATCCATTAAA
GAGCCCTTCCTTCATTCTA -> AGCCCTTCCTTCATTCTAG
AGCCCTTCCTTCATTCTAG -> GCCCTTCCTTCATTCTAGT
ACCTGCGGAACTAGCCAGC -> CCTGCGGAACTAGCCAGCT
CCTGCGGAACTAGCCAGCT -> CTGCGGAACTAGCCAGCTG
TCAGCTACTTTGGAAGCCA -> CAGCTACTTTGGAAGCCAT
CAGCTACTTTGGAAGCCAT -> AGCTACTTTGGAAGCCATA
AAACATGCCATGACAGAAC -> AACATGCCATGACAGAACG
AACATGCCATGACAGAACG -> ACATGCCATGACAGAACGC
ATTCCCCCTTAGCGACCAG -> TTCCCCCTTAGCGACCAGT
TTCCCCCTTAGCGACCAGT -> TCCCCCTTAGCGACCAGTA
GGGGAGAATTAACACTAGG -> GGGAGAATTAACACTAGGG
CACTATAATGTTATATGGA -> ACTATAATGTTATATGGAA
ACTATAATGTTATATGGAA -> CTATAATGTTATATGGAAA
GCCGCAATTATGATAAATC -> CCGCAATTATGATAAATCC
AGCTCCACACTGTCTAATT -> GCTCCACACTGTCTAATTA
GCGACTTGATGCTCTACTA -> CGACTTGATGCTCTACTAC
CGACTTGATGCTCTACTAC -> GACTTGATGCTCTACTACG
ACGTCTCGTAAATGGTTTA -> CGTCTCGTAAATGGTTTAG
CGTCTCGTAAATGGTTTAG -> GTCTCGTAAATGGTTTAGC
TCCGGGCGCAACAGTTGTC -> CCGGGCGCAACAGTTGTCA
AGACCATAGTATGCTTATT -> GACCATAGTATGCTTATTC
CTCGTAGATGCCATACCGT -> TCGTAGATGCCATACCGTA
TCGTAGATGCCATACCGTA -> CGTAGATGCCATACCGTAA
CTGTAAGATGTAGCGCGCT -> TGTAAGATGTAGCGCGCTC
TGTAAGATGTAGCGCGCTC -> GTAAGATGTAGCGCGCTCC
TGGGGACTCCCTTCAGGGC -> GGGGACTCCCTTCAGGGCC
GGGGACTCCCTTCAGGGCC -> GGGACTCCCTTCAGGGCCC
CTAGGGGGTTTTTCACGCT -> TAGGGGGTTTTTCACGCTC
TAGGGGGTTTTTCACGCTC -> AGGGGGTTTTTCACGCTCT
GGCAACGGGGAGAATTAAC -> GCAACGGGGAGAATTAACA
GCAACGGGGAGAATTAACA -> CAACGGGGAGAATTAACAC
CGGGCCAGTAATGTACGTA -> GGGCCAGTAATGTACGTAG
GGGCCAGTAATGTACGTAG -> GGCCAGTAATGTACGTAGA
CTCTGTTCTTGTCTCGTGA -> TCTGTTCTTGTCTCGTGAG
TCTGTTCTTGTCTCGTGAG -> CTGTTCTTGTCTCGTGAGG
AAAGTAGAGCTATATAGGG -> AAGTAGAGCTATATAGGGC
AAGTAGAGCTATATAGGGC -> AGTAGAGCTATATAGGGCT
ATGGTGAACTGAGTTACTA -> TGGTGAACTGAGTTACTAC
TGGTGAACTGAGTTACTAC -> GGTGAACTGAGTTACTACT
GAACTAGCCAGCTGCCCGT -> AACTAGCCAGCTGCCCGTG
AACTAGCCAGCTGCCCGTG -> ACTAGCCAGCTGCCCGTGG
TCGGCAAACACTTGTCCTT -> CGGCAAACACTTGTCCTTT
AGATGTAGCGCGCTCCCGC -> GATGTAGCGCGCTCCCGCG
GATGTAGCGCGCTCCCGCG -> ATGTAGCGCGCTCCCGCGG
TGTACGTAGAGGTGAGCAA -> GTACGTAGAGGTGAGCAAT
GTACGTAGAGGTGAGCAAT -> TACGTAGAGGTGAGCAATG
TCCACAGAGGCTGGTCGAT -> CCACAGAGGCTGGTCGATC
CCACAGAGGCTGGTCGATC -> CACAGAGGCTGGTCGATCA
CGCATACTAATTTCCTCTG -> GCATACTAATTTCCTCTGG
ATCCCGTCCGACGAGGGAA -> TCCCGTCCGACGAGGGAAG
TCCCGTCCGACGAGGGAAG -> CCCGTCCGACGAGGGAAGG
GCAATGGGACGATGCTGCC -> CAATGGGACGATGCTGCCA
CGAATGAGAGGAGAATCCC -> GAATGAGAGGAGAATCCCG
GAATGAGAGGAGAATCCCG -> AATGAGAGGAGAATCCCGT
GCTACTGGTCGCGGCGAGA -> CTACTGGTCGCGGCGAGAA
TTGCGTTGCTCTAGGGGGT -> TGCGTTGCTCTAGGGGGTT
TGCGTTGCTCTAGGGGGTT -> GCGTTGCTCTAGGGGGTTT
ACTGACAGGCACTGCCCTG -> CTGACAGGCACTGCCCTGT
CTGACAGGCACTGCCCTGT -> TGACAGGCACTGCCCTGTA
GTAGAGGTGAGCAATGCGA -> TAGAGGTGAGCAATGCGAA
TAGAGGTGAGCAATGCGAA -> AGAGGTGAGCAATGCGAAC
GGGCTTTTATTTCCACAGA -> GGCTTTTATTTCCACAGAG
GGCTTTTATTTCCACAGAG -> GCTTTTATTTCCACAGAGG
ACGCTCTTTTGTGTTTCAA -> CGCTCTTTTGTGTTTCAAC
CGCTCTTTTGTGTTTCAAC -> GCTCTTTTGTGTTTCAACA
ACCGCCAGATCGTCATGGA -> CCGCCAGATCGTCATGGAG
CCGCCAGATCGTCATGGAG -> CGCCAGATCGTCATGGAGC
GAGAATCCCGTCCGACGAG -> AGAATCCCGTCCGACGAGG
AGAATCCCGTCCGACGAGG -> GAATCCCGTCCGACGAGGG
GACCATAGTATGCTTATTC -> ACCATAGTATGCTTATTCA
AGCCTTCATACACGAGTCA -> GCCTTCATACACGAGTCAA
GTCTTTTCTGTAAGATGTA -> TCTTTTCTGTAAGATGTAG
TCTTTTCTGTAAGATGTAG -> CTTTTCTGTAAGATGTAGC
TTTGATAACTTTTCCCGTC -> TTGATAACTTTTCCCGTCC
TTGATAACTTTTCCCGTCC -> TGATAACTTTTCCCGTCCG
GAAGCCATATGTCGAATGA -> AAGCCATATGTCGAATGAG
TAATGATTCCCCCTTAGCG -> AATGATTCCCCCTTAGCGA
AATGATTCCCCCTTAGCGA -> ATGATTCCCCCTTAGCGAC
AACATTGAAGGTCTTATAT -> ACATTGAAGGTCTTATATA
ACATTGAAGGTCTTATATA -> CATTGAAGGTCTTATATAT
CTGATCCCACCCTTGAGTC -> TGATCCCACCCTTGAGTCC
TGATCCCACCCTTGAGTCC -> GATCCCACCCTTGAGTCCG
GCGACCAGTAGCGAGCGCA -> CGACCAGTAGCGAGCGCAT
GAACTGAGTTACTACTGAG -> AACTGAGTTACTACTGAGC
AACTGAGTTACTACTGAGC -> ACTGAGTTACTACTGAGCG
CTTTTCTGTAAGATGTAGC -> TTTTCTGTAAGATGTAGCG
GGACGTCTCATGGGGACTC -> GACGTCTCATGGGGACTCC
GACGTCTCATGGGGACTCC -> ACGTCTCATGGGGACTCCC
CATACTAATTTCCTCTGGG -> ATACTAATTTCCTCTGGGA
ACCATAGTATGCTTATTCA -> CCATAGTATGCTTATTCAA
CCATAGTATGCTTATTCAA -> CATAGTATGCTTATTCAAG
GCTTTAGAATCGTAAACCT -> CTTTAGAATCGTAAACCTA
CTTTAGAATCGTAAACCTA -> TTTAGAATCGTAAACCTAA
TGAAGGTCTTATATATAAT -> GAAGGTCTTATATATAATT
GAAGGTCTTATATATAATT -> AAGGTCTTATATATAATTA
TTCTAAATAGGATATGGTG -> TCTAAATAGGATATGGTGA
TCTAAATAGGATATGGTGA -> CTAAATAGGATATGGTGAA
GTCGCTGCCAGGGCTCGCC -> TCGCTGCCAGGGCTCGCCT
TCGCTGCCAGGGCTCGCCT -> CGCTGCCAGGGCTCGCCTT
GGCCCAAAAAGTAGTGCGT -> GCCCAAAAAGTAGTGCGTT
TACAGAATAAGCCTTCATA -> ACAGAATAAGCCTTCATAC
ACAGAATAAGCCTTCATAC -> CAGAATAAGCCTTCATACA
TATAGCGAAACCGAAGGTT -> ATAGCGAAACCGAAGGTTG
ATAGCGAAACCGAAGGTTG -> TAGCGAAACCGAAGGTTGG
TCTCGTCACCACCCGTGCC -> CTCGTCACCACCCGTGCCT
CTCGTCACCACCCGTGCCT -> TCGTCACCACCCGTGCCTC
CGATGGGACAGCCGTTCGG -> GATGGGACAGCCGTTCGGT
GATGGGACAGCCGTTCGGT -> ATGGGACAGCCGTTCGGTG
GGTATTTAGCCCGTAGCGT -> GTATTTAGCCCGTAGCGTG
GTATTTAGCCCGTAGCGTG -> TATTTAGCCCGTAGCGTGC
GAGCTATATAGGGCTTTTA -> AGCTATATAGGGCTTTTAT
CCCTTAGCGACCAGTAGCG -> CCTTAGCGACCAGTAGCGA
CCTTAGCGACCAGTAGCGA -> CTTAGCGACCAGTAGCGAG
GTCACACTATAATGTTATA -> TCACACTATAATGTTATAT
TAGGGGGACTTGCTTTAGA -> AGGGGGACTTGCTTTAGAA
AGGGGGACTTGCTTTAGAA -> GGGGGACTTGCTTTAGAAT
ACGCTCTCGTCACCACCCG -> CGCTCTCGTCACCACCCGT
CGCTCTCGTCACCACCCGT -> GCTCTCGTCACCACCCGTG
GTAGGTATGCATCCCCTCT -> TAGGTATGCATCCCCTCTG
TAGGTATGCATCCCCTCTG -> AGGTATGCATCCCCTCTGT
ATTTCCGTAATCTGTGTAG -> TTTCCGTAATCTGTGTAGC
TTTCCGTAATCTGTGTAGC -> TTCCGTAATCTGTGTAGCC
TAAACCTGCGGAACTAGCC -> AAACCTGCGGAACTAGCCA
AAACCTGCGGAACTAGCCA -> AACCTGCGGAACTAGCCAG
AACCAAACGGTCTTGGCAG -> ACCAAACGGTCTTGGCAGA
ACCAAACGGTCTTGGCAGA -> CCAAACGGTCTTGGCAGAC
CCTCACCGCCAGATCGTCA -> CTCACCGCCAGATCGTCAT
GTAACACTAATTTATATAT -> TAACACTAATTTATATATC
TAACACTAATTTATATATC -> AACACTAATTTATATATCC
AATGTTATATGGAAACTAC -> ATGTTATATGGAAACTACA
TCATCGCACAAATCATATG -> CATCGCACAAATCATATGG
GTAAAATGATATTACTAAC -> TAAAATGATATTACTAACG
TTGAAGGTCTTATATATAA -> TGAAGGTCTTATATATAAT
TGCTCTACTACGGCAGGAA -> GCTCTACTACGGCAGGAAA
GCTCTACTACGGCAGGAAA -> CTCTACTACGGCAGGAAAC
CAGTAGCGAGCGCATGGCA -> AGTAGCGAGCGCATGGCAA
AGTAGCGAGCGCATGGCAA -> GTAGCGAGCGCATGGCAAC
GACTCCCTTCAGGGCCCAA -> ACTCCCTTCAGGGCCCAAA
ACTCCCTTCAGGGCCCAAA -> CTCCCTTCAGGGCCCAAAA
CTCGCCTTAAGGAATTTCC -> TCGCCTTAAGGAATTTCCG
TCGCCTTAAGGAATTTCCG -> CGCCTTAAGGAATTTCCGT
CGAGCCGGCCCGATTCCCG -> GAGCCGGCCCGATTCCCGG
GAGCCGGCCCGATTCCCGG -> AGCCGGCCCGATTCCCGGT
CAGTTGTTCGTAAACTGAT -> AGTTGTTCGTAAACTGATT
GCGAGATAGGGGGACTTGC -> CGAGATAGGGGGACTTGCT
CGAGATAGGGGGACTTGCT -> GAGATAGGGGGACTTGCTT
TCCAGGCCCGAAATGTCAT -> CCAGGCCCGAAATGTCATC
CCAGGCCCGAAATGTCATC -> CAGGCCCGAAATGTCATCG
GCGCAATGGGACGATGCTG -> CGCAATGGGACGATGCTGC
CGCAATGGGACGATGCTGC -> GCAATGGGACGATGCTGCC
CCAGATCGTCATGGAGCAC -> CAGATCGTCATGGAGCACG
CTACTGGTCGCGGCGAGAA -> TACTGGTCGCGGCGAGAAA
CTAAAGTGGCAGCAGGAAG -> TAAAGTGGCAGCAGGAAGC
ATGCATCCCCTCTGTTCTT -> TGCATCCCCTCTGTTCTTG
TGCATCCCCTCTGTTCTTG -> GCATCCCCTCTGTTCTTGT
CCCGCGGCATCTACATAAT -> CCGCGGCATCTACATAATG
CCGCGGCATCTACATAATG -> CGCGGCATCTACATAATGA
ACTCTCGTGAAAGCTTTGA -> CTCTCGTGAAAGCTTTGAT
CTCTCGTGAAAGCTTTGAT -> TCTCGTGAAAGCTTTGATA
TTCAAGCGAATATAAGATT -> TCAAGCGAATATAAGATTG
TCAAGCGAATATAAGATTG -> CAAGCGAATATAAGATTGC
CCCTGGTCCCGCTCGGCAC -> CCTGGTCCCGCTCGGCACG
TAAGATGTAGCGCGCTCCC -> AAGATGTAGCGCGCTCCCG
AAGATGTAGCGCGCTCCCG -> AGATGTAGCGCGCTCCCGC
CAGCGCGCGTGGCCGCGCT -> AGCGCGCGTGGCCGCGCTC
AGCGCGCGTGGCCGCGCTC -> GCGCGCGTGGCCGCGCTCT
CAATAACACTAAAGTGGCA -> AATAACACTAAAGTGGCAG
AATAACACTAAAGTGGCAG -> ATAACACTAAAGTGGCAGC
ATGACGGCTTCTAAGGTGA -> TGACGGCTTCTAAGGTGAG
TGACGGCTTCTAAGGTGAG -> GACGGCTTCTAAGGTGAGG
CTATAATGTTATATGGAAA -> TATAATGTTATATGGAAAC
GCTCCACACTGTCTAATTA -> CTCCACACTGTCTAATTAG
CTCCACACTGTCTAATTAG -> TCCACACTGTCTAATTAGC
CTAACGCGTGGTGACCGCG -> TAACGCGTGGTGACCGCGA
TAACGCGTGGTGACCGCGA -> AACGCGTGGTGACCGCGAT
TATATATCCATTAAACGGG -> ATATATCCATTAAACGGGC
AGGGGGTTTTTCACGCTCT -> GGGGGTTTTTCACGCTCTC
CCCTTCCTTCATTCTAGTT -> CCTTCCTTCATTCTAGTTG
CCTTCCTTCATTCTAGTTG -> CTTCCTTCATTCTAGTTGG
TGGTTTAGCGAGCCCTTCC -> GGTTTAGCGAGCCCTTCCT
GGTTTAGCGAGCCCTTCCT -> GTTTAGCGAGCCCTTCCTT
GTAGCCCCGCCCCTTCGCA -> TAGCCCCGCCCCTTCGCAT
TAGCCCCGCCCCTTCGCAT -> AGCCCCGCCCCTTCGCATA
ATAGAATTTAAGACTTAGG -> TAGAATTTAAGACTTAGGG
TAGAATTTAAGACTTAGGG -> AGAATTTAAGACTTAGGGC
TCACACTATAATGTTATAT -> CACACTATAATGTTATATG
TAATTTAGTTTGCGCCGCA -> AATTTAGTTTGCGCCGCAA
AATTTAGTTTGCGCCGCAA -> ATTTAGTTTGCGCCGCAAT
CAGTTGTCACACCGTTTCC -> AGTTGTCACACCGTTTCCA
AGTTGTCACACCGTTTCCA -> GTTGTCACACCGTTTCCAG
GCAGGAAACATGCCATGAC -> CAGGAAACATGCCATGACA
ACTGGCGTTGAGCCGTAGG -> CTGGCGTTGAGCCGTAGGT
ACTTGCTTTAGAATCGTAA -> CTTGCTTTAGAATCGTAAA
CTTGCTTTAGAATCGTAAA -> TTGCTTTAGAATCGTAAAC
GGACTGGCGTTGAGCCGTA -> GACTGGCGTTGAGCCGTAG
GACTGGCGTTGAGCCGTAG -> ACTGGCGTTGAGCCGTAGG
GAGGACGTCTCATGGGGAC -> AGGACGTCTCATGGGGACT
AATCATATGGTAACACTAA -> ATCATATGGTAACACTAAT
ATCATATGGTAACACTAAT -> TCATATGGTAACACTAATT
GCACTGTAGCGCGAAACCC -> CACTGTAGCGCGAAACCCA
CACTGTAGCGCGAAACCCA -> ACTGTAGCGCGAAACCCAG
TCTCCCCTGGTCCCGCTCG -> CTCCCCTGGTCCCGCTCGG
CTCCCCTGGTCCCGCTCGG -> TCCCCTGGTCCCGCTCGGC
TGTTAGCCCAACGAGCCGG -> GTTAGCCCAACGAGCCGGC
AATGTACGTAGAGGTGAGC -> ATGTACGTAGAGGTGAGCA
TATATATAATTAAAATTGG -> ATATATAATTAAAATTGGA
ATATATAATTAAAATTGGA -> TATATAATTAAAATTGGAG
ATTCAAGCGAATATAAGAT -> TTCAAGCGAATATAAGATT
ACTTTGGAAGCCATATGTC -> CTTTGGAAGCCATATGTCG
ACAGCCGTTCGGTGTGTCT -> CAGCCGTTCGGTGTGTCTT
CAGCCGTTCGGTGTGTCTT -> AGCCGTTCGGTGTGTCTTT
TTGTCACACCGTTTCCAGG -> TGTCACACCGTTTCCAGGC
TTTTGTGTTTCAACAGCGT -> TTTGTGTTTCAACAGCGTT
TTTGTGTTTCAACAGCGTT -> TTGTGTTTCAACAGCGTTG
TGCAAGCTATAGAACGTTT -> GCAAGCTATAGAACGTTTC
GCAAGCTATAGAACGTTTC -> CAAGCTATAGAACGTTTCG
CCAGTAATGTACGTAGAGG -> CAGTAATGTACGTAGAGGT
CAGTAATGTACGTAGAGGT -> AGTAATGTACGTAGAGGTG
CTGGTCGCGGCGAGAAAGG -> TGGTCGCGGCGAGAAAGGC
TGGTCGCGGCGAGAAAGGC -> GGTCGCGGCGAGAAAGGCT
ACTAGAGCGTAATACCCCA -> CTAGAGCGTAATACCCCAC
CTAGAGCGTAATACCCCAC -> TAGAGCGTAATACCCCACT
TTGTGTTTCAACAGCGTTG -> TGTGTTTCAACAGCGTTGA
CGTTGATTTACAGTTCTCC -> GTTGATTTACAGTTCTCCC
ATGACACGAAGACCAGTTG -> TGACACGAAGACCAGTTGC
TGACACGAAGACCAGTTGC -> GACACGAAGACCAGTTGCG
GGTAACCAAACGGTCTTGG -> GTAACCAAACGGTCTTGGC
GTAACCAAACGGTCTTGGC -> TAACCAAACGGTCTTGGCA
TTCATTCTAGTTGGGTCTT -> TCATTCTAGTTGGGTCTTG
TCATTCTAGTTGGGTCTTG -> CATTCTAGTTGGGTCTTGC
GTAAGATGTAGCGCGCTCC -> TAAGATGTAGCGCGCTCCC
GGCTCTTTAGTTGTAGATA -> GCTCTTTAGTTGTAGATAT
GCTCTTTAGTTGTAGATAT -> CTCTTTAGTTGTAGATATA
AATTAGCCCAACGAGCCGG -> ATTAGCCCAACGAGCCGGC
TGAGGGTCATCGCACAAAT -> GAGGGTCATCGCACAAATC
GAGGGTCATCGCACAAATC -> AGGGTCATCGCACAAATCA
TAGCCAGCTGCCCGTGGAC -> AGCCAGCTGCCCGTGGACA
CATATGTAAACCTGCGGAA -> ATATGTAAACCTGCGGAAC
ATATGTAAACCTGCGGAAC -> TATGTAAACCTGCGGAACT
CGGTGCTGCGACTTGATGC -> GGTGCTGCGACTTGATGCT
GCCTCGGGGGACGAAGGCA -> CCTCGGGGGACGAAGGCAG
TTTCCCGTCCGTCGTAATT -> TTCCCGTCCGTCGTAATTT
TTCCCGTCCGTCGTAATTT -> TCCCGTCCGTCGTAATTTA
GCCTCACCGCCAGATCGTC -> CCTCACCGCCAGATCGTCA
AGATAGGGGGACTTGCTTT -> GATAGGGGGACTTGCTTTA
GATAGGGGGACTTGCTTTA -> ATAGGGGGACTTGCTTTAG
AAATGATATTACTAACGCA -> AATGATATTACTAACGCAC
AATGATATTACTAACGCAC -> ATGATATTACTAACGCACG
TCGTAAATGGTTTAGCGAG -> CGTAAATGGTTTAGCGAGC
CGTAAATGGTTTAGCGAGC -> GTAAATGGTTTAGCGAGCC
GCTCTTTTGTGTTTCAACA -> CTCTTTTGTGTTTCAACAG
ATACAGAATAAGCCTTCAT -> TACAGAATAAGCCTTCATA
CATTGAAGGTCTTATATAT -> ATTGAAGGTCTTATATATA
AGCCATATGTAAACCTGCG -> GCCATATGTAAACCTGCGG
GTCTCATGGGGACTCCCTT -> TCTCATGGGGACTCCCTTC
TCTCATGGGGACTCCCTTC -> CTCATGGGGACTCCCTTCA
TTTGACACGGGTACTTTGG -> TTGACACGGGTACTTTGGA
TTGACACGGGTACTTTGGA -> TGACACGGGTACTTTGGAA
TACATAACGGGCTGTGAGC -> ACATAACGGGCTGTGAGCG
ACATAACGGGCTGTGAGCG -> CATAACGGGCTGTGAGCGC
CGGCTTTGACACGGGTACT -> GGCTTTGACACGGGTACTT
GGCTTTGACACGGGTACTT -> GCTTTGACACGGGTACTTT
CGTCGTAATTTAGTTTGCG -> GTCGTAATTTAGTTTGCGC
GTCGTAATTTAGTTTGCGC -> TCGTAATTTAGTTTGCGCC
CTGTAAGCTTACAAGAGTC -> TGTAAGCTTACAAGAGTCA
TGTAAGCTTACAAGAGTCA -> GTAAGCTTACAAGAGTCAG
GCTGCGACTTGATGCTCTA -> CTGCGACTTGATGCTCTAC
CTGCGACTTGATGCTCTAC -> TGCGACTTGATGCTCTACT
GCAACTCTCGTGAAAGCTT -> CAACTCTCGTGAAAGCTTT
TCCACACTGTCTAATTAGC -> CCACACTGTCTAATTAGCC
CCACACTGTCTAATTAGCC -> CACACTGTCTAATTAGCCC
TACCCCACTTCGGCAAACA -> ACCCCACTTCGGCAAACAC
GTAGCGAGCGCATGGCAAC -> TAGCGAGCGCATGGCAACT
TAGCGAGCGCATGGCAACT -> AGCGAGCGCATGGCAACTC
CCCGCCCCTTCGCATACTA -> CCGCCCCTTCGCATACTAA
CGTTTCGGTGCTGCGACTT -> GTTTCGGTGCTGCGACTTG
GTTTCGGTGCTGCGACTTG -> TTTCGGTGCTGCGACTTGA
TATATCCATTAAACGGGCC -> ATATCCATTAAACGGGCCA
ATATCCATTAAACGGGCCA -> TATCCATTAAACGGGCCAG
TAAATAGGATATGGTGAAC -> AAATAGGATATGGTGAACT
AAATAGGATATGGTGAACT -> AATAGGATATGGTGAACTG
TTGCTCTAGGGGGTTTTTC -> TGCTCTAGGGGGTTTTTCA
TGCTCTAGGGGGTTTTTCA -> GCTCTAGGGGGTTTTTCAC
CCCTCACCTGAGCAATCGG -> CCTCACCTGAGCAATCGGC
CCTCACCTGAGCAATCGGC -> CTCACCTGAGCAATCGGCT
CTGTCGCTGCCAGGGCTCG -> TGTCGCTGCCAGGGCTCGC
TGTCGCTGCCAGGGCTCGC -> GTCGCTGCCAGGGCTCGCC
ATACCGTAAATACAGAATA -> TACCGTAAATACAGAATAA
TACCGTAAATACAGAATAA -> ACCGTAAATACAGAATAAG
GGTAACCCGAGACTAGAGC -> GTAACCCGAGACTAGAGCG
CGAGATGTGCACCGTGACC -> GAGATGTGCACCGTGACCC
GAGATGTGCACCGTGACCC -> AGATGTGCACCGTGACCCT
CCCAAAAAGTAGTGCGTTC -> CCAAAAAGTAGTGCGTTCT
CCAAAAAGTAGTGCGTTCT -> CAAAAAGTAGTGCGTTCTG
AGTTAAGCACAAGAGTACT -> GTTAAGCACAAGAGTACTA
GTTAAGCACAAGAGTACTA -> TTAAGCACAAGAGTACTAA
AAGCTTTGATAACTTTTCC -> AGCTTTGATAACTTTTCCC
CGGGCTGTGAGCGCAGTCC -> GGGCTGTGAGCGCAGTCCA
GGGCTGTGAGCGCAGTCCA -> GGCTGTGAGCGCAGTCCAA
TGGCAGCAGGAAGCGCTAT -> GGCAGCAGGAAGCGCTATA
GGCAGCAGGAAGCGCTATA -> GCAGCAGGAAGCGCTATAG
GGTAGACAGGCGTAAAATG -> GTAGACAGGCGTAAAATGA
CAAGCGAATATAAGATTGC -> AAGCGAATATAAGATTGCG
GTGAGCAATGCGAACCCTG -> TGAGCAATGCGAACCCTGA
TGAGCAATGCGAACCCTGA -> GAGCAATGCGAACCCTGAC
TATATAATTAAAATTGGAG -> ATATAATTAAAATTGGAGC
ATATAATTAAAATTGGAGC -> TATAATTAAAATTGGAGCA
AGGAAGCGCTATAGAATTT -> GGAAGCGCTATAGAATTTA
GGAAGCGCTATAGAATTTA -> GAAGCGCTATAGAATTTAA
CCTGAGCAATCGGCTCTTT -> CTGAGCAATCGGCTCTTTA
CTGAGTTACTACTGAGCGA -> TGAGTTACTACTGAGCGAT
TCTAATTAGCCCAACGAGC -> CTAATTAGCCCAACGAGCC
CTAATTAGCCCAACGAGCC -> TAATTAGCCCAACGAGCCG
TAGAACGTTTCGGTGCTGC -> AGAACGTTTCGGTGCTGCG
AACGGTCTTGGCAGACCAC -> ACGGTCTTGGCAGACCACT
ACGGTCTTGGCAGACCACT -> CGGTCTTGGCAGACCACTC
CATTCCTGTCGCTGCCAGG -> ATTCCTGTCGCTGCCAGGG
ATTCCTGTCGCTGCCAGGG -> TTCCTGTCGCTGCCAGGGC
ATACCCCACTTCGGCAAAC -> TACCCCACTTCGGCAAACA
CTTCCTTCATTCTAGTTGG -> TTCCTTCATTCTAGTTGGG
TTCCTTCATTCTAGTTGGG -> TCCTTCATTCTAGTTGGGT
TTCCCGGTACTTTGGAAGC -> TCCCGGTACTTTGGAAGCC
TCCCGGTACTTTGGAAGCC -> CCCGGTACTTTGGAAGCCA
TGGACTGACAGGCACTGCC -> GGACTGACAGGCACTGCCC
GGACTGACAGGCACTGCCC -> GACTGACAGGCACTGCCCT
AGCCCAACGAGCCGGCTTT -> GCCCAACGAGCCGGCTTTG
TTTGATACTTTGGAAGCCA -> TTGATACTTTGGAAGCCAT
AGGCACTGCCCTGTAGAGG -> GGCACTGCCCTGTAGAGGA
GGCACTGCCCTGTAGAGGA -> GCACTGCCCTGTAGAGGAG
TGTGGGCAAGACTGATTGG -> GTGGGCAAGACTGATTGGC
CTACACTCCTTCGTGGAAA -> TACACTCCTTCGTGGAAAC
TACACTCCTTCGTGGAAAC -> ACACTCCTTCGTGGAAACA
CGCGCCTCGTAGATGCCAT -> GCGCCTCGTAGATGCCATA
CGAAGGTTGGTATTTAGCC -> GAAGGTTGGTATTTAGCCC
CACTCTCCGGGCGCAACAG -> ACTCTCCGGGCGCAACAGT
ACTCTCCGGGCGCAACAGT -> CTCTCCGGGCGCAACAGTT
TGCCTCACCGCCAGATCGT -> GCCTCACCGCCAGATCGTC
TTTTCCCGTCCGTCGTAAT -> TTTCCCGTCCGTCGTAATT
GAGTAAAACTTAGCCCAAC -> AGTAAAACTTAGCCCAACG
AGTAAAACTTAGCCCAACG -> GTAAAACTTAGCCCAACGA
TGACACGGGTACTTTGGAA -> GACACGGGTACTTTGGAAG
CATAATGACGGCTTCTAAG -> ATAATGACGGCTTCTAAGG
GGGCAAGACTGATTGGCCT -> GGCAAGACTGATTGGCCTC
GGCAAGACTGATTGGCCTC -> GCAAGACTGATTGGCCTCG
CCAGCTGCCCGTGGACACG -> CAGCTGCCCGTGGACACGC
TACACGAGTCAAGTACGTG -> ACACGAGTCAAGTACGTGG
TGTGTTTCAACAGCGTTGA -> GTGTTTCAACAGCGTTGAT
CGGTCTTGGCAGACCACTC -> GGTCTTGGCAGACCACTCT
GAGCAATGCGAACCCTGAC -> AGCAATGCGAACCCTGACT
ATAGGGCTTTTATTTCCAC -> TAGGGCTTTTATTTCCACA
TAGGGCTTTTATTTCCACA -> AGGGCTTTTATTTCCACAG
GCGCATGGCAACTCTCGTG -> CGCATGGCAACTCTCGTGA
TTTGGAAGCCATATGTCGA -> TTGGAAGCCATATGTCGAA
TTGGAAGCCATATGTCGAA -> TGGAAGCCATATGTCGAAT
GGCGAGAAAGGCTGTAAGC -> GCGAGAAAGGCTGTAAGCT
GCGAGAAAGGCTGTAAGCT -> CGAGAAAGGCTGTAAGCTT
AGGACGTCTCATGGGGACT -> GGACGTCTCATGGGGACTC
ACCCTCACCTGAGCAATCG -> CCCTCACCTGAGCAATCGG
CGAAGACCAGTTGCGTTGC -> GAAGACCAGTTGCGTTGCT
CTAGTTGGGTCTTGCACCA -> TAGTTGGGTCTTGCACCAT
ATATATCCATTAAACGGGC -> TATATCCATTAAACGGGCC
CCCGTAGCGTGCTCAAAGT -> CCGTAGCGTGCTCAAAGTA
CCGTAGCGTGCTCAAAGTA -> CGTAGCGTGCTCAAAGTAG
GATATTACTAACGCACGCT -> ATATTACTAACGCACGCTC
ATATTACTAACGCACGCTC -> TATTACTAACGCACGCTCT
GTTCAGCAGTTGTTCGTAA -> TTCAGCAGTTGTTCGTAAA
TTCAGCAGTTGTTCGTAAA -> TCAGCAGTTGTTCGTAAAC
GAAGACCAGTTGCGTTGCT -> AAGACCAGTTGCGTTGCTC
GTACTTTGGAAGCCATATG -> TACTTTGGAAGCCATATGT,TACTTTGGAAGCCATATGT
GGCCTCGGGGGACGAAGGC -> GCCTCGGGGGACGAAGGCA
TAAGCTTACAAGAGTCAGC -> AAGCTTACAAGAGTCAGCG
GGTACTTTGGAAGCCATAT -> GTACTTTGGAAGCCATATG,GTACTTTGGAAGCCATATG
CACTGTCTAATTAGCCCAA -> ACTGTCTAATTAGCCCAAC
ACTGTCTAATTAGCCCAAC -> CTGTCTAATTAGCCCAACG
GTCTAATTAGCCCAACGAG -> TCTAATTAGCCCAACGAGC
CCGCGGAAATCATGCAAGC -> CGCGGAAATCATGCAAGCT
CGCGGAAATCATGCAAGCT -> GCGGAAATCATGCAAGCTA
ACACGGGTACTTTGGAAGC -> CACGGGTACTTTGGAAGCC
CACGGGTACTTTGGAAGCC -> ACGGGTACTTTGGAAGCCA
GGCAGGCGCGCCTCGTAGA -> GCAGGCGCGCCTCGTAGAT
GCAGGCGCGCCTCGTAGAT -> CAGGCGCGCCTCGTAGATG
GGCTTCCAAGGAGTAAAAC -> GCTTCCAAGGAGTAAAACT
GCTTCCAAGGAGTAAAACT -> CTTCCAAGGAGTAAAACTT
TGATAACTTTTCCCGTCCG -> GATAACTTTTCCCGTCCGT
CAATTATGATAAATCCCCT -> AATTATGATAAATCCCCTC
AATTATGATAAATCCCCTC -> ATTATGATAAATCCCCTCG
GATACTTTGGAAGCCATAT -> ATACTTTGGAAGCCATATG
ATACTTTGGAAGCCATATG -> TACTTTGGAAGCCATATGT
ACAAGAGTCAGCGGCCCCC -> CAAGAGTCAGCGGCCCCCG
CAAGAGTCAGCGGCCCCCG -> AAGAGTCAGCGGCCCCCGC
GTCAAGTACGTGGGTAGAC -> TCAAGTACGTGGGTAGACA
TCAAGTACGTGGGTAGACA -> CAAGTACGTGGGTAGACAG
CAGAGGCTGGTCGATCAAT -> AGAGGCTGGTCGATCAATA
CGCCGCACGGCTTCTAAAT -> GCCGCACGGCTTCTAAATA
GCCGCACGGCTTCTAAATA -> CCGCACGGCTTCTAAATAG
CACAAATCATATGGTAACA -> ACAAATCATATGGTAACAC
ACAAATCATATGGTAACAC -> CAAATCATATGGTAACACT
CTATATAGGGCTTTTATTT -> TATATAGGGCTTTTATTTC
TCGTGAAAGCTTTGATAAC -> CGTGAAAGCTTTGATAACT
CGTGAAAGCTTTGATAACT -> GTGAAAGCTTTGATAACTT
GAGTCCGCGGAAATCATGC -> AGTCCGCGGAAATCATGCA
AGTCCGCGGAAATCATGCA -> GTCCGCGGAAATCATGCAA
GGTATGCATCCCCTCTGTT -> GTATGCATCCCCTCTGTTC
GTATGCATCCCCTCTGTTC -> TATGCATCCCCTCTGTTCT
CTGTCTAATTAGCCCAACG -> TGTCTAATTAGCCCAACGA
TGTCTAATTAGCCCAACGA -> GTCTAATTAGCCCAACGAG
GTTGGCGCCGCACGGCTTC -> TTGGCGCCGCACGGCTTCT
CACCACCCGTGCCTCACCG -> ACCACCCGTGCCTCACCGC
ACCACCCGTGCCTCACCGC -> CCACCCGTGCCTCACCGCC
TGATGCTCTACTACGGCAG -> GATGCTCTACTACGGCAGG
GATGCTCTACTACGGCAGG -> ATGCTCTACTACGGCAGGA
TCATACACGAGTCAAGTAC -> CATACACGAGTCAAGTACG
TTTCACGCTCTCGTCACCA -> TTCACGCTCTCGTCACCAC
TTCACGCTCTCGTCACCAC -> TCACGCTCTCGTCACCACC
CCGCGATACCATAATGATT -> CGCGATACCATAATGATTC
CGCGATACCATAATGATTC -> GCGATACCATAATGATTCC
CGGTACTTTGGAAGCCATA -> GGTACTTTGGAAGCCATAT
GGATGGGTGTCTCGGCATT -> GATGGGTGTCTCGGCATTC
GATGGGTGTCTCGGCATTC -> ATGGGTGTCTCGGCATTCC
ATTTCCTCTGGGACTGGCG -> TTTCCTCTGGGACTGGCGT
TTTCCTCTGGGACTGGCGT -> TTCCTCTGGGACTGGCGTT
AAGGAATTTCCGTAATCTG -> AGGAATTTCCGTAATCTGT
AGGAATTTCCGTAATCTGT -> GGAATTTCCGTAATCTGTG
ATAACACTAAAGTGGCAGC -> TAACACTAAAGTGGCAGCA
TAACACTAAAGTGGCAGCA -> AACACTAAAGTGGCAGCAG
AGACTTAGGGCTTCCAAGG -> GACTTAGGGCTTCCAAGGA
GACTTAGGGCTTCCAAGGA -> ACTTAGGGCTTCCAAGGAG
ACTGTAGCGCGAAACCCAG -> CTGTAGCGCGAAACCCAGA
GTTCTTGTCTCGTGAGGGT -> TTCTTGTCTCGTGAGGGTC
TTCTTGTCTCGTGAGGGTC -> TCTTGTCTCGTGAGGGTCA
CTGCCAGGGCTCGCCTTAA -> TGCCAGGGCTCGCCTTAAG
TGCCAGGGCTCGCCTTAAG -> GCCAGGGCTCGCCTTAAGG
TTTAGCCCAACGAGCCGGC -> TTAGCCCAACGAGCCGGCT
TTAGCCCAACGAGCCGGCT -> TAGCCCAACGAGCCGGCTT
TCTGCCCGAGATGTGCACC -> CTGCCCGAGATGTGCACCG
CTGCCCGAGATGTGCACCG -> TGCCCGAGATGTGCACCGT
GAAGGCAGGCGCGCCTCGT -> AAGGCAGGCGCGCCTCGTA
CTTCTAAGGTGAGGGCTCT -> TTCTAAGGTGAGGGCTCTC
TGGCCGCGCTCTCGACTCG -> GGCCGCGCTCTCGACTCGT
GGCCGCGCTCTCGACTCGT -> GCCGCGCTCTCGACTCGTG
CGACTCGTGAGTTGTTGTG -> GACTCGTGAGTTGTTGTGC
TCCCGTCCGTCGTAATTTA -> CCCGTCCGTCGTAATTTAG
ACCGCGAGATAGGGGGACT -> CCGCGAGATAGGGGGACTT
CGAGTCAAGTACGTGGGTA -> GAGTCAAGTACGTGGGTAG
GAGTCAAGTACGTGGGTAG -> AGTCAAGTACGTGGGTAGA
CTCACCTGAGCAATCGGCT -> TCACCTGAGCAATCGGCTC
TCACCTGAGCAATCGGCTC -> CACCTGAGCAATCGGCTCT
GGGGGACTTGCTTTAGAAT -> GGGGACTTGCTTTAGAATC
TAACCAAACGGTCTTGGCA -> AACCAAACGGTCTTGGCAG
TAGCCACGTCAGTCACACT -> AGCCACGTCAGTCACACTA
AGTTGCGTTGCTCTAGGGG -> GTTGCGTTGCTCTAGGGGG
GTTGCGTTGCTCTAGGGGG -> TTGCGTTGCTCTAGGGGGT
GGTCTTATATATAATTAAA -> GTCTTATATATAATTAAAA
GTCTTATATATAATTAAAA -> TCTTATATATAATTAAAAT
AACGTTTCGGTGCTGCGAC -> ACGTTTCGGTGCTGCGACT
GTAGCGCGCTCCCGCGGCA -> TAGCGCGCTCCCGCGGCAT
TAGCGCGCTCCCGCGGCAT -> AGCGCGCTCCCGCGGCATC
CCAAGGAGTAAAACTTAGC -> CAAGGAGTAAAACTTAGCC
CAAGGAGTAAAACTTAGCC -> AAGGAGTAAAACTTAGCCC
ATGGGACGATGCTGCCATG -> TGGGACGATGCTGCCATGT
GGCAATGTATTTGATACTT -> GCAATGTATTTGATACTTT
GCAATGTATTTGATACTTT -> CAATGTATTTGATACTTTG
TTTCGGTGCTGCGACTTGA -> TTCGGTGCTGCGACTTGAT
AACAAAGTGTTAGCCCAAC -> ACAAAGTGTTAGCCCAACG
ACAAAGTGTTAGCCCAACG -> CAAAGTGTTAGCCCAACGA
GGACGATGCTGCCATGTTG -> GACGATGCTGCCATGTTGT
CGGCTTCTAAGGTGAGGGC -> GGCTTCTAAGGTGAGGGCT
GGCTTCTAAGGTGAGGGCT -> GCTTCTAAGGTGAGGGCTC
ATCCCCTCGAGAGGACGTC -> TCCCCTCGAGAGGACGTCT
TCCCCTCGAGAGGACGTCT -> CCCCTCGAGAGGACGTCTC
GCGAGCCCTTCCTTCATTC -> CGAGCCCTTCCTTCATTCT
AGATATAGCGAAACCGAAG -> GATATAGCGAAACCGAAGG
TCCTTCATTCTAGTTGGGT -> CCTTCATTCTAGTTGGGTC
CCTTCATTCTAGTTGGGTC -> CTTCATTCTAGTTGGGTCT
TCGTGGAAACAGCTCCACA -> CGTGGAAACAGCTCCACAC
CGTGGAAACAGCTCCACAC -> GTGGAAACAGCTCCACACT
CAGGCGCGCCTCGTAGATG -> AGGCGCGCCTCGTAGATGC
CTCTAGGGGGTTTTTCACG -> TCTAGGGGGTTTTTCACGC
TCTAGGGGGTTTTTCACGC -> CTAGGGGGTTTTTCACGCT
CAAAGTGTTAGCCCAACGA -> AAAGTGTTAGCCCAACGAG
AAAGTGTTAGCCCAACGAG -> AAGTGTTAGCCCAACGAGC
CCCGTCCGACGAGGGAAGG -> CCGTCCGACGAGGGAAGGT
GTTGTTGTGCTGATGATCC -> TTGTTGTGCTGATGATCCG
TTGTTGTGCTGATGATCCG -> TGTTGTGCTGATGATCCGG
AGATACATAACGGGCTGTG -> GATACATAACGGGCTGTGA
CGTGCTCAAAGTAGAGCTA -> GTGCTCAAAGTAGAGCTAT
CCAACGAGCCGGCTTTGAC -> CAACGAGCCGGCTTTGACA
TTTCTGTAAGATGTAGCGC -> TTCTGTAAGATGTAGCGCG
ATGTTGGGATGGGTGTCTC -> TGTTGGGATGGGTGTCTCG
TGTTGGGATGGGTGTCTCG -> GTTGGGATGGGTGTCTCGG
CAAGCTATAGAACGTTTCG -> AAGCTATAGAACGTTTCGG
AAGCTATAGAACGTTTCGG -> AGCTATAGAACGTTTCGGT
CTTCTAAATAGGATATGGT -> TTCTAAATAGGATATGGTG
TAGGGCTTCCAAGGAGTAA -> AGGGCTTCCAAGGAGTAAA
AGGGCTTCCAAGGAGTAAA -> GGGCTTCCAAGGAGTAAAA
CTGCGGAACTAGCCAGCTG -> TGCGGAACTAGCCAGCTGC
TGCGGAACTAGCCAGCTGC -> GCGGAACTAGCCAGCTGCC
TATCCATTAAACGGGCCAG -> ATCCATTAAACGGGCCAGT
ATCCATTAAACGGGCCAGT -> TCCATTAAACGGGCCAGTA
GATCAATAACACTAAAGTG -> ATCAATAACACTAAAGTGG
ATCAATAACACTAAAGTGG -> TCAATAACACTAAAGTGGC
TACTCGTTGCGGCCCCCTC -> ACTCGTTGCGGCCCCCTCT
ACTCGTTGCGGCCCCCTCT -> CTCGTTGCGGCCCCCTCTG
GCTTACAAGAGTCAGCGGC -> CTTACAAGAGTCAGCGGCC
CTTACAAGAGTCAGCGGCC -> TTACAAGAGTCAGCGGCCC
ACCACTCTCCGGGCGCAAC -> CCACTCTCCGGGCGCAACA
AGCACGGAATCTCTGATCC -> GCACGGAATCTCTGATCCC
GTGTTTCAACAGCGTTGAT -> TGTTTCAACAGCGTTGATT
TGTTTCAACAGCGTTGATT -> GTTTCAACAGCGTTGATTT
GAGAATTAACACTAGGGTA -> AGAATTAACACTAGGGTAA
AGAATTAACACTAGGGTAA -> GAATTAACACTAGGGTAAC
ACTTTGGAAGCCATATGTA -> CTTTGGAAGCCATATGTAA
CCGCGCTCTCGACTCGTGA -> CGCGCTCTCGACTCGTGAG
CGCGCTCTCGACTCGTGAG -> GCGCTCTCGACTCGTGAGT
CTGTTCTTGTCTCGTGAGG -> TGTTCTTGTCTCGTGAGGG
ACTGAGTTACTACTGAGCG -> CTGAGTTACTACTGAGCGA
TCGAGAGGACGTCTCATGG -> CGAGAGGACGTCTCATGGG
CGAGAGGACGTCTCATGGG -> GAGAGGACGTCTCATGGGG
GTGCGTTCTGCCCGAGATG -> TGCGTTCTGCCCGAGATGT
TGCGTTCTGCCCGAGATGT -> GCGTTCTGCCCGAGATGTG
CTACATAATGACGGCTTCT -> TACATAATGACGGCTTCTA
AACACTAAAGTGGCAGCAG -> ACACTAAAGTGGCAGCAGG
CTCGGCATTCCGGGAGCTA -> TCGGCATTCCGGGAGCTAC
TCGGCATTCCGGGAGCTAC -> CGGCATTCCGGGAGCTACT
ATTGAAGGTCTTATATATA -> TTGAAGGTCTTATATATAA
ACGGGTACTTTGGAAGCCA -> CGGGTACTTTGGAAGCCAT
ACTGATTGGCCTCGGGGGA -> CTGATTGGCCTCGGGGGAC
ACCCGTGCCTCACCGCCAG -> CCCGTGCCTCACCGCCAGA
CCCGTGCCTCACCGCCAGA -> CCGTGCCTCACCGCCAGAT
TTGCGTTGGCGCCGCACGG -> TGCGTTGGCGCCGCACGGC
TGCGTTGGCGCCGCACGGC -> GCGTTGGCGCCGCACGGCT
TAGCCCAACGAGCCGGCTT -> AGCCCAACGAGCCGGCTTT
TATAATGTTATATGGAAAC -> ATAATGTTATATGGAAACT
CCTTTCAACGTCTCGTAAA -> CTTTCAACGTCTCGTAAAT
CTTTCAACGTCTCGTAAAT -> TTTCAACGTCTCGTAAATG
AAGTGGCAGCAGGAAGCGC -> AGTGGCAGCAGGAAGCGCT
AGTGGCAGCAGGAAGCGCT -> GTGGCAGCAGGAAGCGCTA
GCGTTGAGCCGTAGGTATG -> CGTTGAGCCGTAGGTATGC
GCTGTGAGCGCAGTCCAAC -> CTGTGAGCGCAGTCCAACA
CTGTGAGCGCAGTCCAACA -> TGTGAGCGCAGTCCAACAT
CGTAAATACAGAATAAGCC -> GTAAATACAGAATAAGCCT
GTAAATACAGAATAAGCCT -> TAAATACAGAATAAGCCTT
CTTTGGAAGCCATATGTTG -> TTTGGAAGCCATATGTTGG
TTTGGAAGCCATATGTTGG -> TTGGAAGCCATATGTTGGG
TTTTAGTTGGTCATTCCTG -> TTTAGTTGGTCATTCCTGT
TGAGCCGTAGGTATGCATC -> GAGCCGTAGGTATGCATCC
GAGCCGTAGGTATGCATCC -> AGCCGTAGGTATGCATCCC
GGGATGGGTGTCTCGGCAT -> GGATGGGTGTCTCGGCATT
GTGGACACGCTCAGACATG -> TGGACACGCTCAGACATGA
TGGACACGCTCAGACATGA -> GGACACGCTCAGACATGAC
CGGCGATCATTCAGCTACT -> GGCGATCATTCAGCTACTT
GGCGATCATTCAGCTACTT -> GCGATCATTCAGCTACTTT
CTACTGAGCGATGGGACAG -> TACTGAGCGATGGGACAGC
TCCCGCTCGGCACGAGTTA -> CCCGCTCGGCACGAGTTAA
CCCGCTCGGCACGAGTTAA -> CCGCTCGGCACGAGTTAAG
CTAAATAGGATATGGTGAA -> TAAATAGGATATGGTGAAC
TTTGGAAGCCATATGTGCA -> TTGGAAGCCATATGTGCAC
CAATGTATTTGATACTTTG -> AATGTATTTGATACTTTGG
AATGTATTTGATACTTTGG -> ATGTATTTGATACTTTGGA
GTAGATATAGCGAAACCGA -> TAGATATAGCGAAACCGAA
TAGATATAGCGAAACCGAA -> AGATATAGCGAAACCGAAG
CCGCAATTATGATAAATCC -> CGCAATTATGATAAATCCC
TATGTCGAATGAGAGGAGA -> ATGTCGAATGAGAGGAGAA
ATGTCGAATGAGAGGAGAA -> TGTCGAATGAGAGGAGAAT
GCCATGTTGTGGGCAAGAC -> CCATGTTGTGGGCAAGACT
CCATGTTGTGGGCAAGACT -> CATGTTGTGGGCAAGACTG
GGGTCATCGCACAAATCAT -> GGTCATCGCACAAATCATA
TTCAGCGCGCGTGGCCGCG -> TCAGCGCGCGTGGCCGCGC
TCAGCGCGCGTGGCCGCGC -> CAGCGCGCGTGGCCGCGCT
ATTGCGTTGGCGCCGCACG -> TTGCGTTGGCGCCGCACGG
TCCGCGGAAATCATGCAAG -> CCGCGGAAATCATGCAAGC
AGGCTGTAAGCTTACAAGA -> GGCTGTAAGCTTACAAGAG
GGCTGTAAGCTTACAAGAG -> GCTGTAAGCTTACAAGAGT
CTCTCGACTCGTGAGTTGT -> TCTCGACTCGTGAGTTGTT
TCTCGACTCGTGAGTTGTT -> CTCGACTCGTGAGTTGTTG
CACGTCAGTCACACTATAA -> ACGTCAGTCACACTATAAT
ACGTCAGTCACACTATAAT -> CGTCAGTCACACTATAATG
CTCATGGGGACTCCCTTCA -> TCATGGGGACTCCCTTCAG
AATCTGTGTAGCCCCGCCC -> ATCTGTGTAGCCCCGCCCC
ATCTGTGTAGCCCCGCCCC -> TCTGTGTAGCCCCGCCCCT
CCACCCGTGCCTCACCGCC -> CACCCGTGCCTCACCGCCA
CACCCGTGCCTCACCGCCA -> ACCCGTGCCTCACCGCCAG
CATAACGGGCTGTGAGCGC -> ATAACGGGCTGTGAGCGCA
ATAACGGGCTGTGAGCGCA -> TAACGGGCTGTGAGCGCAG
TGGCAGACCACTCTCCGGG -> GGCAGACCACTCTCCGGGC
GGCAGACCACTCTCCGGGC -> GCAGACCACTCTCCGGGCG
ACGAGCCGGCGATCATTCA -> CGAGCCGGCGATCATTCAG
AGTAGAGCTATATAGGGCT -> GTAGAGCTATATAGGGCTT
CACGGCTTCTAAATAGGAT -> ACGGCTTCTAAATAGGATA
GCGGAAATCATGCAAGCTA -> CGGAAATCATGCAAGCTAT
CGGAAATCATGCAAGCTAT -> GGAAATCATGCAAGCTATA
CGCGCTCCCGCGGCATCTA -> GCGCTCCCGCGGCATCTAC
GCGAAACCGAAGGTTGGTA -> CGAAACCGAAGGTTGGTAT
CGAAACCGAAGGTTGGTAT -> GAAACCGAAGGTTGGTATT
GTGCACCGTGACCCTCACC -> TGCACCGTGACCCTCACCT
TGCACCGTGACCCTCACCT -> GCACCGTGACCCTCACCTG
GTAATCTGTGTAGCCCCGC -> TAATCTGTGTAGCCCCGCC
TAATCTGTGTAGCCCCGCC -> AATCTGTGTAGCCCCGCCC
GTACTAAGAATTCAGCGCG -> TACTAAGAATTCAGCGCGC
AGCGCGCTCCCGCGGCATC -> GCGCGCTCCCGCGGCATCT
GCCCTTCCTTCATTCTAGT -> CCCTTCCTTCATTCTAGTT
GCCATATGTTGGGATGGGT -> CCATATGTTGGGATGGGTG
CCATATGTTGGGATGGGTG -> CATATGTTGGGATGGGTGT
TGGGATGGGTGTCTCGGCA -> GGGATGGGTGTCTCGGCAT
AATGAGAGGAGAATCCCGT -> ATGAGAGGAGAATCCCGTC
AACCTGCGGAACTAGCCAG -> ACCTGCGGAACTAGCCAGC
ACGGGCCAGTAATGTACGT -> CGGGCCAGTAATGTACGTA
GCTCTCGTCACCACCCGTG -> CTCTCGTCACCACCCGTGC
GTCCTTTCAACGTCTCGTA -> TCCTTTCAACGTCTCGTAA
TCCTTTCAACGTCTCGTAA -> CCTTTCAACGTCTCGTAAA
ACGAGTCAAGTACGTGGGT -> CGAGTCAAGTACGTGGGTA
ATGTAGCGCGCTCCCGCGG -> TGTAGCGCGCTCCCGCGGC
AAGGAGTAAAACTTAGCCC -> AGGAGTAAAACTTAGCCCA
CTCTCGTCACCACCCGTGC -> TCTCGTCACCACCCGTGCC
AACCCAGACCATAGTATGC -> ACCCAGACCATAGTATGCT
ACCCAGACCATAGTATGCT -> CCCAGACCATAGTATGCTT
ACATGACACGAAGACCAGT -> CATGACACGAAGACCAGTT
CATGACACGAAGACCAGTT -> ATGACACGAAGACCAGTTG
ATGTTATATGGAAACTACA -> TGTTATATGGAAACTACAC
TGTTATATGGAAACTACAC -> GTTATATGGAAACTACACT
TAAGCACAAGAGTACTAAG -> AAGCACAAGAGTACTAAGA
GCGGCGAGAAAGGCTGTAA -> CGGCGAGAAAGGCTGTAAG
CGGCGAGAAAGGCTGTAAG -> GGCGAGAAAGGCTGTAAGC
AGTGCGTTCTGCCCGAGAT -> GTGCGTTCTGCCCGAGATG
GTCGATCAATAACACTAAA -> TCGATCAATAACACTAAAG
TCGATCAATAACACTAAAG -> CGATCAATAACACTAAAGT
CGAGCCCTTCCTTCATTCT -> GAGCCCTTCCTTCATTCTA
GAGATAGGGGGACTTGCTT -> AGATAGGGGGACTTGCTTT
TAAACGGGCCAGTAATGTA -> AAACGGGCCAGTAATGTAC
AAACGGGCCAGTAATGTAC -> AACGGGCCAGTAATGTACG
AAAGTAGTGCGTTCTGCCC -> AAGTAGTGCGTTCTGCCCG
AAGTAGTGCGTTCTGCCCG -> AGTAGTGCGTTCTGCCCGA
CGTGAGTTGTTGTGCTGAT -> GTGAGTTGTTGTGCTGATG
GAATAAGCCTTCATACACG -> AATAAGCCTTCATACACGA
AATAAGCCTTCATACACGA -> ATAAGCCTTCATACACGAG
TAAAGTGGCAGCAGGAAGC -> AAAGTGGCAGCAGGAAGCG
AAAGTGGCAGCAGGAAGCG -> AAGTGGCAGCAGGAAGCGC
CGTGAGGGTCATCGCACAA -> GTGAGGGTCATCGCACAAA
GTGAGGGTCATCGCACAAA -> TGAGGGTCATCGCACAAAT
TAATTTCCTCTGGGACTGG -> AATTTCCTCTGGGACTGGC
CGTAGCGTGCTCAAAGTAG -> GTAGCGTGCTCAAAGTAGA
TCCGACGAGGGAAGGTTAC -> CCGACGAGGGAAGGTTACT
CGGGTACTTTGGAAGCCAT -> GGGTACTTTGGAAGCCATA
GGGTCTTGCACCATTTAGC -> GGTCTTGCACCATTTAGCC
GGTAACACTAATTTATATA -> GTAACACTAATTTATATAT
AAGGTCTTATATATAATTA -> AGGTCTTATATATAATTAA
TTGTCTCGTGAGGGTCATC -> TGTCTCGTGAGGGTCATCG
TGTCTCGTGAGGGTCATCG -> GTCTCGTGAGGGTCATCGC
CCCGAGACTAGAGCGTAAT -> CCGAGACTAGAGCGTAATA
CCGAGACTAGAGCGTAATA -> CGAGACTAGAGCGTAATAC
TTTTCTGTAAGATGTAGCG -> TTTCTGTAAGATGTAGCGC
GCGTTCTGCCCGAGATGTG -> CGTTCTGCCCGAGATGTGC
CGTTCTGCCCGAGATGTGC -> GTTCTGCCCGAGATGTGCA
TAAATACAGAATAAGCCTT -> AAATACAGAATAAGCCTTC
CAAACGGTCTTGGCAGACC -> AAACGGTCTTGGCAGACCA
AAACGGTCTTGGCAGACCA -> AACGGTCTTGGCAGACCAC
CCACCCTTGAGTCCGCGGA -> CACCCTTGAGTCCGCGGAA
CACCCTTGAGTCCGCGGAA -> ACCCTTGAGTCCGCGGAAA
AAGAGTCAGCGGCCCCCGC -> AGAGTCAGCGGCCCCCGCG
AGAGTCAGCGGCCCCCGCG -> GAGTCAGCGGCCCCCGCGC
GTAAACTGATTCTAGCCAC -> TAAACTGATTCTAGCCACG
GAGAAAGGCTGTAAGCTTA -> AGAAAGGCTGTAAGCTTAC
AGAAAGGCTGTAAGCTTAC -> GAAAGGCTGTAAGCTTACA
CTCCCGCGGCATCTACATA -> TCCCGCGGCATCTACATAA
CTAGGGTAACCAAACGGTC -> TAGGGTAACCAAACGGTCT
TAGGGTAACCAAACGGTCT -> AGGGTAACCAAACGGTCTT
CTCCGGGCGCAACAGTTGT -> TCCGGGCGCAACAGTTGTC
AGGGCTCTCCCCTGGTCCC -> GGGCTCTCCCCTGGTCCCG
GGGCTCTCCCCTGGTCCCG -> GGCTCTCCCCTGGTCCCGC
GCGCCTCGTAGATGCCATA -> CGCCTCGTAGATGCCATAC
CGCCTCGTAGATGCCATAC -> GCCTCGTAGATGCCATACC
ACTCGTGAGTTGTTGTGCT -> CTCGTGAGTTGTTGTGCTG
CTCGTGAGTTGTTGTGCTG -> TCGTGAGTTGTTGTGCTGA
ACTTTGGAAGCCATATGTT -> CTTTGGAAGCCATATGTTG
ACGTTTCGGTGCTGCGACT -> CGTTTCGGTGCTGCGACTT
CGCGGCGAGAAAGGCTGTA -> GCGGCGAGAAAGGCTGTAA
ACGGCTTCTAAATAGGATA -> CGGCTTCTAAATAGGATAT
TTTAGTTGTAGATATAGCG -> TTAGTTGTAGATATAGCGA
TTAGTTGTAGATATAGCGA -> TAGTTGTAGATATAGCGAA
TCCTTCGTGGAAACAGCTC -> CCTTCGTGGAAACAGCTCC
CAATGCGAACCCTGACTAG -> AATGCGAACCCTGACTAGC
TCAGCGGCCCCCGCGCAAT -> CAGCGGCCCCCGCGCAATG
CAGCGGCCCCCGCGCAATG -> AGCGGCCCCCGCGCAATGG
CATACACGAGTCAAGTACG -> ATACACGAGTCAAGTACGT
ATTAAACGGGCCAGTAATG -> TTAAACGGGCCAGTAATGT
TTAAACGGGCCAGTAATGT -> TAAACGGGCCAGTAATGTA
CAGGCCCGAAATGTCATCG -> AGGCCCGAAATGTCATCGT
AGGCCCGAAATGTCATCGT -> GGCCCGAAATGTCATCGTG
TGTAGCGCGAAACCCAGAC -> GTAGCGCGAAACCCAGACC
GTAGCGCGAAACCCAGACC -> TAGCGCGAAACCCAGACCA
CCAGTAGCGAGCGCATGGC -> CAGTAGCGAGCGCATGGCA
CTCTTTAGTTGTAGATATA -> TCTTTAGTTGTAGATATAG
TCTTTAGTTGTAGATATAG -> CTTTAGTTGTAGATATAGC
ATATAAGATTGCGTTGGCG -> TATAAGATTGCGTTGGCGC
CGTAAACTGATTCTAGCCA -> GTAAACTGATTCTAGCCAC
ATGTGCACTGTAGCGCGAA -> TGTGCACTGTAGCGCGAAA
TGTGCACTGTAGCGCGAAA -> GTGCACTGTAGCGCGAAAC
AGTATGCTTATTCAAGCGA -> GTATGCTTATTCAAGCGAA
GTATGCTTATTCAAGCGAA -> TATGCTTATTCAAGCGAAT
CCGCGAGATAGGGGGACTT -> CGCGAGATAGGGGGACTTG
CGCGAGATAGGGGGACTTG -> GCGAGATAGGGGGACTTGC
GCACGCTCTTTTGTGTTTC -> CACGCTCTTTTGTGTTTCA
CACGCTCTTTTGTGTTTCA -> ACGCTCTTTTGTGTTTCAA
GTCTCGTGAGGGTCATCGC -> TCTCGTGAGGGTCATCGCA
TTTAGTTGGTCATTCCTGT -> TTAGTTGGTCATTCCTGTC
TCCATTAAACGGGCCAGTA -> CCATTAAACGGGCCAGTAA
TCCCCCTTAGCGACCAGTA -> CCCCCTTAGCGACCAGTAG
CCCCCTTAGCGACCAGTAG -> CCCCTTAGCGACCAGTAGC
ACTTCGGCAAACACTTGTC -> CTTCGGCAAACACTTGTCC
ACCATAATGATTCCCCCTT -> CCATAATGATTCCCCCTTA
TTGGGATGGGTGTCTCGGC -> TGGGATGGGTGTCTCGGCA
ATCGTCATGGAGCACGGAA -> TCGTCATGGAGCACGGAAT
ACAAGAGTACTAAGAATTC -> CAAGAGTACTAAGAATTCA
TATGCATCCCCTCTGTTCT -> ATGCATCCCCTCTGTTCTT
CGTTTCCAGGCCCGAAATG -> GTTTCCAGGCCCGAAATGT
GTTTCCAGGCCCGAAATGT -> TTTCCAGGCCCGAAATGTC
TCATCGTGGTCCTCACATC -> CATCGTGGTCCTCACATCC
GCGCTCTCGACTCGTGAGT -> CGCTCTCGACTCGTGAGTT
TAACACTAGGGTAACCAAA -> AACACTAGGGTAACCAAAC
TATGGAAACTACACTCCTT -> ATGGAAACTACACTCCTTC
ATGGAAACTACACTCCTTC -> TGGAAACTACACTCCTTCG
CTCGTTGCGGCCCCCTCTG -> TCGTTGCGGCCCCCTCTGG
TCGTTGCGGCCCCCTCTGG -> CGTTGCGGCCCCCTCTGGA
CGCATGGCAACTCTCGTGA -> GCATGGCAACTCTCGTGAA
ATAATGATTCCCCCTTAGC -> TAATGATTCCCCCTTAGCG
GCTTCTAAGGTGAGGGCTC -> CTTCTAAGGTGAGGGCTCT
TGCGACTTGATGCTCTACT -> GCGACTTGATGCTCTACTA
TAAATCCCCTCGAGAGGAC -> AAATCCCCTCGAGAGGACG
ATGGGACAGCCGTTCGGTG -> TGGGACAGCCGTTCGGTGT
ATGAGAGGAGAATCCCGTC -> TGAGAGGAGAATCCCGTCC
ATTATGATAAATCCCCTCG -> TTATGATAAATCCCCTCGA
TTATGATAAATCCCCTCGA -> TATGATAAATCCCCTCGAG
AATCGGCTCTTTAGTTGTA -> ATCGGCTCTTTAGTTGTAG
ATCGGCTCTTTAGTTGTAG -> TCGGCTCTTTAGTTGTAGA
TCCCTTCAGGGCCCAAAAA -> CCCTTCAGGGCCCAAAAAG
CCCTTCAGGGCCCAAAAAG -> CCTTCAGGGCCCAAAAAGT
GGTCGCGGCGAGAAAGGCT -> GTCGCGGCGAGAAAGGCTG
CATTCTAGTTGGGTCTTGC -> ATTCTAGTTGGGTCTTGCA
CCGGTACTTTGGAAGCCAT -> CGGTACTTTGGAAGCCATA
ATTTAGTTTGCGCCGCAAT -> TTTAGTTTGCGCCGCAATT
GCATCCCCTCTGTTCTTGT -> CATCCCCTCTGTTCTTGTC
CATCCCCTCTGTTCTTGTC -> ATCCCCTCTGTTCTTGTCT
TCCAAGGAGTAAAACTTAG -> CCAAGGAGTAAAACTTAGC
GCAGGAAGCGCTATAGAAT -> CAGGAAGCGCTATAGAATT
CAGGAAGCGCTATAGAATT -> AGGAAGCGCTATAGAATTT
CAGGAAACATGCCATGACA -> AGGAAACATGCCATGACAG
AGGAAACATGCCATGACAG -> GGAAACATGCCATGACAGA
TCGGTGTGTCTTTTCTGTA -> CGGTGTGTCTTTTCTGTAA
CGGTGTGTCTTTTCTGTAA -> GGTGTGTCTTTTCTGTAAG
GCACGGAATCTCTGATCCC -> CACGGAATCTCTGATCCCA
AGTAATGTACGTAGAGGTG -> GTAATGTACGTAGAGGTGA
TTTAGAATCGTAAACCTAA -> TTAGAATCGTAAACCTAAC
TTAGAATCGTAAACCTAAC -> TAGAATCGTAAACCTAACG
TTGATGCTCTACTACGGCA -> TGATGCTCTACTACGGCAG
TGCCATGACAGAACGCGGA -> GCCATGACAGAACGCGGAG
GCCATGACAGAACGCGGAG -> CCATGACAGAACGCGGAGT
GTTGAGCCGTAGGTATGCA -> TTGAGCCGTAGGTATGCAT
TTGAGCCGTAGGTATGCAT -> TGAGCCGTAGGTATGCATC
CTCTCCGGGCGCAACAGTT -> TCTCCGGGCGCAACAGTTG
TCTCCGGGCGCAACAGTTG -> CTCCGGGCGCAACAGTTGT
CAAAAAGTAGTGCGTTCTG -> AAAAAGTAGTGCGTTCTGC
AAAAAGTAGTGCGTTCTGC -> AAAAGTAGTGCGTTCTGCC
ATGCTGCCATGTTGTGGGC -> TGCTGCCATGTTGTGGGCA
TGCTGCCATGTTGTGGGCA -> GCTGCCATGTTGTGGGCAA
CGGCATTCCGGGAGCTACT -> GGCATTCCGGGAGCTACTG
CTTAGGGCTTCCAAGGAGT -> TTAGGGCTTCCAAGGAGTA
TTAGGGCTTCCAAGGAGTA -> TAGGGCTTCCAAGGAGTAA
ATGCTCTACTACGGCAGGA -> TGCTCTACTACGGCAGGAA
GGCCCGAAATGTCATCGTG -> GCCCGAAATGTCATCGTGG
GCCCGAAATGTCATCGTGG -> CCCGAAATGTCATCGTGGT
ATGTCATCGTGGTCCTCAC -> TGTCATCGTGGTCCTCACA
TTGTAGATATAGCGAAACC -> TGTAGATATAGCGAAACCG
TGTGAGCGCAGTCCAACAT -> GTGAGCGCAGTCCAACATT
TTAGCGAGCCCTTCCTTCA -> TAGCGAGCCCTTCCTTCAT
GCTGTAAGCTTACAAGAGT -> CTGTAAGCTTACAAGAGTC
TCTGATCCCACCCTTGAGT -> CTGATCCCACCCTTGAGTC
GCCTTCATACACGAGTCAA -> CCTTCATACACGAGTCAAG
CCTTCATACACGAGTCAAG -> CTTCATACACGAGTCAAGT
GAGCCGGCAATGTATTTGA -> AGCCGGCAATGTATTTGAT
AGCCGGCAATGTATTTGAT -> GCCGGCAATGTATTTGATA
GTTGGGTCTTGCACCATTT -> TTGGGTCTTGCACCATTTA
ATTCAGCGCGCGTGGCCGC -> TTCAGCGCGCGTGGCCGCG
ACACCGTTTCCAGGCCCGA -> CACCGTTTCCAGGCCCGAA
GGCGCAACAGTTGTCACAC -> GCGCAACAGTTGTCACACC
GCGCAACAGTTGTCACACC -> CGCAACAGTTGTCACACCG
GATTCCCGGTACTTTGGAA -> ATTCCCGGTACTTTGGAAG
ATTCCCGGTACTTTGGAAG -> TTCCCGGTACTTTGGAAGC
GTAAAACTTAGCCCAACGA -> TAAAACTTAGCCCAACGAG
TAAGAATTCAGCGCGCGTG -> AAGAATTCAGCGCGCGTGG
CATCGTGGTCCTCACATCC -> ATCGTGGTCCTCACATCCC
ATCGTGGTCCTCACATCCC -> TCGTGGTCCTCACATCCCT
TCGCACAAATCATATGGTA -> CGCACAAATCATATGGTAA
TAGAATCGTAAACCTAACG -> AGAATCGTAAACCTAACGC
ACACTCCTTCGTGGAAACA -> CACTCCTTCGTGGAAACAG
CACTCCTTCGTGGAAACAG -> ACTCCTTCGTGGAAACAGC
GCGCGTGGCCGCGCTCTCG -> CGCGTGGCCGCGCTCTCGA
CGCGTGGCCGCGCTCTCGA -> GCGTGGCCGCGCTCTCGAC
CCAACGAGCCGGCCCGATT -> CAACGAGCCGGCCCGATTC
GTGAACTGAGTTACTACTG -> TGAACTGAGTTACTACTGA
TGAACTGAGTTACTACTGA -> GAACTGAGTTACTACTGAG
ACACTATAATGTTATATGG -> CACTATAATGTTATATGGA
CTCTGATCCCACCCTTGAG -> TCTGATCCCACCCTTGAGT
CGCACAAATCATATGGTAA -> GCACAAATCATATGGTAAC
CATTCAGCTACTTTGGAAG -> ATTCAGCTACTTTGGAAGC
ATTCAGCTACTTTGGAAGC -> TTCAGCTACTTTGGAAGCC
CGCAGTCCAACATTGAAGG -> GCAGTCCAACATTGAAGGT
GCAGTCCAACATTGAAGGT -> CAGTCCAACATTGAAGGTC
GATACCATAATGATTCCCC -> ATACCATAATGATTCCCCC
GTGAAAGCTTTGATAACTT -> TGAAAGCTTTGATAACTTT
CCCACCCTTGAGTCCGCGG -> CCACCCTTGAGTCCGCGGA
TACTAAGAATTCAGCGCGC -> ACTAAGAATTCAGCGCGCG
ACTAAGAATTCAGCGCGCG -> CTAAGAATTCAGCGCGCGT
ACGGCTTCTAAGGTGAGGG -> CGGCTTCTAAGGTGAGGGC
TTCAACAGCGTTGATTTAC -> TCAACAGCGTTGATTTACA
AATCTCTGATCCCACCCTT -> ATCTCTGATCCCACCCTTG
ATCTCTGATCCCACCCTTG -> TCTCTGATCCCACCCTTGA
CGGCACGAGTTAAGCACAA -> GGCACGAGTTAAGCACAAG
GGCACGAGTTAAGCACAAG -> GCACGAGTTAAGCACAAGA
AGCCGGCTTTGACACGGGT -> GCCGGCTTTGACACGGGTA
GCCGGCTTTGACACGGGTA -> CCGGCTTTGACACGGGTAC
AGCTACTTTGGAAGCCATA -> GCTACTTTGGAAGCCATAT
CAGCGTTGATTTACAGTTC -> AGCGTTGATTTACAGTTCT
AGCGTTGATTTACAGTTCT -> GCGTTGATTTACAGTTCTC
GTTTCAACAGCGTTGATTT -> TTTCAACAGCGTTGATTTA
TTTCAACAGCGTTGATTTA -> TTCAACAGCGTTGATTTAC
AGATGTGCACCGTGACCCT -> GATGTGCACCGTGACCCTC
TGCCATGTTGTGGGCAAGA -> GCCATGTTGTGGGCAAGAC
TCATTCAGCTACTTTGGAA -> CATTCAGCTACTTTGGAAG
CCTGACTAGCGGCAACGGG -> CTGACTAGCGGCAACGGGG
CTGACTAGCGGCAACGGGG -> TGACTAGCGGCAACGGGGA
CTTTAGTTGTAGATATAGC -> TTTAGTTGTAGATATAGCG
AAGGTTGGTATTTAGCCCG -> AGGTTGGTATTTAGCCCGT
AGGTTGGTATTTAGCCCGT -> GGTTGGTATTTAGCCCGTA
TGCCATACCGTAAATACAG -> GCCATACCGTAAATACAGA
GCCATACCGTAAATACAGA -> CCATACCGTAAATACAGAA
TGTGCACCGTGACCCTCAC -> GTGCACCGTGACCCTCACC
CATATGTTGGGATGGGTGT -> ATATGTTGGGATGGGTGTC
GAAACTACACTCCTTCGTG -> AAACTACACTCCTTCGTGG
AAACTACACTCCTTCGTGG -> AACTACACTCCTTCGTGGA
CGTGCCTCACCGCCAGATC -> GTGCCTCACCGCCAGATCG
GTGCCTCACCGCCAGATCG -> TGCCTCACCGCCAGATCGT
GGATATGGTGAACTGAGTT -> GATATGGTGAACTGAGTTA
GATATGGTGAACTGAGTTA -> ATATGGTGAACTGAGTTAC
ATGATTCCCCCTTAGCGAC -> TGATTCCCCCTTAGCGACC
CAGGGCCCAAAAAGTAGTG -> AGGGCCCAAAAAGTAGTGC
AGGTCTTATATATAATTAA -> GGTCTTATATATAATTAAA
ACAGTTCTCCCAACAAAGT -> CAGTTCTCCCAACAAAGTG
GCTGGTCGATCAATAACAC -> CTGGTCGATCAATAACACT
CTGGTCGATCAATAACACT -> TGGTCGATCAATAACACTA
CTTATATATAATTAAAATT -> TTATATATAATTAAAATTG
TTATATATAATTAAAATTG -> TATATATAATTAAAATTGG
CCGCTCGGCACGAGTTAAG -> CGCTCGGCACGAGTTAAGC
GCGCGCTCCCGCGGCATCT -> CGCGCTCCCGCGGCATCTA
CATGACAGAACGCGGAGTA -> ATGACAGAACGCGGAGTAT
ATGACAGAACGCGGAGTAT -> TGACAGAACGCGGAGTATT
ACATCCCTAGTAAAAGTTC -> CATCCCTAGTAAAAGTTCA
CATCCCTAGTAAAAGTTCA -> ATCCCTAGTAAAAGTTCAG
AACAGCTCCACACTGTCTA -> ACAGCTCCACACTGTCTAA
AGGGTCATCGCACAAATCA -> GGGTCATCGCACAAATCAT
TTGTTCGTAAACTGATTCT -> TGTTCGTAAACTGATTCTA
CCATGACAGAACGCGGAGT -> CATGACAGAACGCGGAGTA
CCCACTTCGGCAAACACTT -> CCACTTCGGCAAACACTTG
CCACTTCGGCAAACACTTG -> CACTTCGGCAAACACTTGT
GTGGCCGCGCTCTCGACTC -> TGGCCGCGCTCTCGACTCG
AGCCGTAGGTATGCATCCC -> GCCGTAGGTATGCATCCCC
CAGAATAAGCCTTCATACA -> AGAATAAGCCTTCATACAC
AGAATAAGCCTTCATACAC -> GAATAAGCCTTCATACACG
CGCGCGTGGCCGCGCTCTC -> GCGCGTGGCCGCGCTCTCG
CCCCTTAGCGACCAGTAGC -> CCCTTAGCGACCAGTAGCG
TGTAGCCCCGCCCCTTCGC -> GTAGCCCCGCCCCTTCGCA
CACACTATAATGTTATATG -> ACACTATAATGTTATATGG
ACTTGTCCTTTCAACGTCT -> CTTGTCCTTTCAACGTCTC
CTTGTCCTTTCAACGTCTC -> TTGTCCTTTCAACGTCTCG
TGCGGCCCCCTCTGGACTG -> GCGGCCCCCTCTGGACTGA
GCGGCCCCCTCTGGACTGA -> CGGCCCCCTCTGGACTGAC
GGCGCCGCACGGCTTCTAA -> GCGCCGCACGGCTTCTAAA
CCATATGTGCACTGTAGCG -> CATATGTGCACTGTAGCGC
CATATGTGCACTGTAGCGC -> ATATGTGCACTGTAGCGCG
TCCTGTCGCTGCCAGGGCT -> CCTGTCGCTGCCAGGGCTC
CCTGTCGCTGCCAGGGCTC -> CTGTCGCTGCCAGGGCTCG
GTGCTCAAAGTAGAGCTAT -> TGCTCAAAGTAGAGCTATA
GAAAGGCTGTAAGCTTACA -> AAAGGCTGTAAGCTTACAA
AAAGGCTGTAAGCTTACAA -> AAGGCTGTAAGCTTACAAG
CCATACCGTAAATACAGAA -> CATACCGTAAATACAGAAT
GCAAGACTGATTGGCCTCG -> CAAGACTGATTGGCCTCGG
GGAATCTCTGATCCCACCC -> GAATCTCTGATCCCACCCT
GAATCTCTGATCCCACCCT -> AATCTCTGATCCCACCCTT
GTCCCGCTCGGCACGAGTT -> TCCCGCTCGGCACGAGTTA
CATACCGTAAATACAGAAT -> ATACCGTAAATACAGAATA
AGCCCCGCCCCTTCGCATA -> GCCCCGCCCCTTCGCATAC
CTTTGGAAGCCATATGTCG -> TTTGGAAGCCATATGTCGA
GCGGAACTAGCCAGCTGCC -> CGGAACTAGCCAGCTGCCC
ATGTGCACCGTGACCCTCA -> TGTGCACCGTGACCCTCAC
AATCGTAAACCTAACGCGT -> ATCGTAAACCTAACGCGTG
TGATGATCCGGTAACCCGA -> GATGATCCGGTAACCCGAG
CTGATTGGCCTCGGGGGAC -> TGATTGGCCTCGGGGGACG
TGATTGGCCTCGGGGGACG -> GATTGGCCTCGGGGGACGA
CCGTTTCCAGGCCCGAAAT -> CGTTTCCAGGCCCGAAATG
GTGGCAGCAGGAAGCGCTA -> TGGCAGCAGGAAGCGCTAT
CCGTAATCTGTGTAGCCCC -> CGTAATCTGTGTAGCCCCG
CGTAATCTGTGTAGCCCCG -> GTAATCTGTGTAGCCCCGC
CGATGCTGCCATGTTGTGG -> GATGCTGCCATGTTGTGGG
GATGCTGCCATGTTGTGGG -> ATGCTGCCATGTTGTGGGC
AGCAATCGGCTCTTTAGTT -> GCAATCGGCTCTTTAGTTG
GCAATCGGCTCTTTAGTTG -> CAATCGGCTCTTTAGTTGT
GCCGCGCTCTCGACTCGTG -> CCGCGCTCTCGACTCGTGA
TAGATGCCATACCGTAAAT -> AGATGCCATACCGTAAATA
AGATGCCATACCGTAAATA -> GATGCCATACCGTAAATAC
AAAGCTTTGATAACTTTTC -> AAGCTTTGATAACTTTTCC
TTTAGCGAGCCCTTCCTTC -> TTAGCGAGCCCTTCCTTCA
AACGCGTGGTGACCGCGAT -> ACGCGTGGTGACCGCGATA
ACGCGTGGTGACCGCGATA -> CGCGTGGTGACCGCGATAC
CTCGTGAGGGTCATCGCAC -> TCGTGAGGGTCATCGCACA
TCGTGAGGGTCATCGCACA -> CGTGAGGGTCATCGCACAA
AGGGCTTTTATTTCCACAG -> GGGCTTTTATTTCCACAGA
AAACAGCTCCACACTGTCT -> AACAGCTCCACACTGTCTA
ATGTACGTAGAGGTGAGCA -> TGTACGTAGAGGTGAGCAA
CCGCACGGCTTCTAAATAG -> CGCACGGCTTCTAAATAGG
AATTAACACTAGGGTAACC -> ATTAACACTAGGGTAACCA
CTCCCTTCAGGGCCCAAAA -> TCCCTTCAGGGCCCAAAAA
CTGGACTGACAGGCACTGC -> TGGACTGACAGGCACTGCC
GGACAGCCGTTCGGTGTGT -> GACAGCCGTTCGGTGTGTC
GACAGCCGTTCGGTGTGTC -> ACAGCCGTTCGGTGTGTCT
GTCTTGGCAGACCACTCTC -> TCTTGGCAGACCACTCTCC
CAACAAAGTGTTAGCCCAA -> AACAAAGTGTTAGCCCAAC
CCCCGCGCAATGGGACGAT -> CCCGCGCAATGGGACGATG
CTTATTCAAGCGAATATAA -> TTATTCAAGCGAATATAAG
CGCTCAGACATGACACGAA -> GCTCAGACATGACACGAAG
ACCTGAGCAATCGGCTCTT -> CCTGAGCAATCGGCTCTTT
ACTGAGCGATGGGACAGCC -> CTGAGCGATGGGACAGCCG
CTGAGCGATGGGACAGCCG -> TGAGCGATGGGACAGCCGT
GCGATCATTCAGCTACTTT -> CGATCATTCAGCTACTTTG
CGATCATTCAGCTACTTTG -> GATCATTCAGCTACTTTGG
AAGGCTGTAAGCTTACAAG -> AGGCTGTAAGCTTACAAGA
CGCAATTATGATAAATCCC -> GCAATTATGATAAATCCCC
GCAATTATGATAAATCCCC -> CAATTATGATAAATCCCCT
CGAGACTAGAGCGTAATAC -> GAGACTAGAGCGTAATACC
TTGGTCATTCCTGTCGCTG -> TGGTCATTCCTGTCGCTGC
TGGTCATTCCTGTCGCTGC -> GGTCATTCCTGTCGCTGCC
TAACTTTTCCCGTCCGTCG -> AACTTTTCCCGTCCGTCGT
AACTTTTCCCGTCCGTCGT -> ACTTTTCCCGTCCGTCGTA
GAGCAATCGGCTCTTTAGT -> AGCAATCGGCTCTTTAGTT
TGAGTCCGCGGAAATCATG -> GAGTCCGCGGAAATCATGC
GGTGAACTGAGTTACTACT -> GTGAACTGAGTTACTACTG
TGATTCCCCCTTAGCGACC -> GATTCCCCCTTAGCGACCA
GATTCCCCCTTAGCGACCA -> ATTCCCCCTTAGCGACCAG
AGCTATAGAACGTTTCGGT -> GCTATAGAACGTTTCGGTG
GCTATAGAACGTTTCGGTG -> CTATAGAACGTTTCGGTGC
TACGTGGGTAGACAGGCGT -> ACGTGGGTAGACAGGCGTA
CGGCTTCTAAATAGGATAT -> GGCTTCTAAATAGGATATG
GTTTGCGCCGCAATTATGA -> TTTGCGCCGCAATTATGAT
TTTGCGCCGCAATTATGAT -> TTGCGCCGCAATTATGATA
GATCATTCAGCTACTTTGG -> ATCATTCAGCTACTTTGGA
ATCATTCAGCTACTTTGGA -> TCATTCAGCTACTTTGGAA
AGACCAGTTGCGTTGCTCT -> GACCAGTTGCGTTGCTCTA
GACCAGTTGCGTTGCTCTA -> ACCAGTTGCGTTGCTCTAG
AAATCCCCTCGAGAGGACG -> AATCCCCTCGAGAGGACGT
AATCCCCTCGAGAGGACGT -> ATCCCCTCGAGAGGACGTC
GGGCGCAACAGTTGTCACA -> GGCGCAACAGTTGTCACAC
AGATCGTCATGGAGCACGG -> GATCGTCATGGAGCACGGA
GATCGTCATGGAGCACGGA -> ATCGTCATGGAGCACGGAA
GTCAGTCACACTATAATGT -> TCAGTCACACTATAATGTT
TCAGTCACACTATAATGTT -> CAGTCACACTATAATGTTA
GTAGACAGGCGTAAAATGA -> TAGACAGGCGTAAAATGAT
TAGACAGGCGTAAAATGAT -> AGACAGGCGTAAAATGATA
TTCAGCTACTTTGGAAGCC -> TCAGCTACTTTGGAAGCCA
TCTCTGATCCCACCCTTGA -> CTCTGATCCCACCCTTGAG
GGAGCATTTTAGTTGGTCA -> GAGCATTTTAGTTGGTCAT
GAGCATTTTAGTTGGTCAT -> AGCATTTTAGTTGGTCATT
AAGTGTTAGCCCAACGAGC -> AGTGTTAGCCCAACGAGCC
TGCTGATGATCCGGTAACC -> GCTGATGATCCGGTAACCC
GCATGGCAACTCTCGTGAA -> CATGGCAACTCTCGTGAAA
CATGGCAACTCTCGTGAAA -> ATGGCAACTCTCGTGAAAG
CACCGCCAGATCGTCATGG -> ACCGCCAGATCGTCATGGA
GGAATTTCCGTAATCTGTG -> GAATTTCCGTAATCTGTGT
GAATTTCCGTAATCTGTGT -> AATTTCCGTAATCTGTGTA
CGAAATGTCATCGTGGTCC -> GAAATGTCATCGTGGTCCT
ATATGGTGAACTGAGTTAC -> TATGGTGAACTGAGTTACT
TATGGTGAACTGAGTTACT -> ATGGTGAACTGAGTTACTA
GATCCCACCCTTGAGTCCG -> ATCCCACCCTTGAGTCCGC
ATCCCACCCTTGAGTCCGC -> TCCCACCCTTGAGTCCGCG
GATTGCGTTGGCGCCGCAC -> ATTGCGTTGGCGCCGCACG
GGAGCTACTGGTCGCGGCG -> GAGCTACTGGTCGCGGCGA
TAGTGCGTTCTGCCCGAGA -> AGTGCGTTCTGCCCGAGAT
TGGAAACTACACTCCTTCG -> GGAAACTACACTCCTTCGT
CCCGATTCCCGGTACTTTG -> CCGATTCCCGGTACTTTGG
AATTTCCTCTGGGACTGGC -> ATTTCCTCTGGGACTGGCG
GTTGTCACACCGTTTCCAG -> TTGTCACACCGTTTCCAGG
TAATACCCCACTTCGGCAA -> AATACCCCACTTCGGCAAA
AATACCCCACTTCGGCAAA -> ATACCCCACTTCGGCAAAC
AACCCGAGACTAGAGCGTA -> ACCCGAGACTAGAGCGTAA
AGCGGCAACGGGGAGAATT -> GCGGCAACGGGGAGAATTA
GACTTGCTTTAGAATCGTA -> ACTTGCTTTAGAATCGTAA
AGGAGTAAAACTTAGCCCA -> GGAGTAAAACTTAGCCCAA
GGAGTAAAACTTAGCCCAA -> GAGTAAAACTTAGCCCAAC
AAGGTTACTCGTTGCGGCC -> AGGTTACTCGTTGCGGCCC
AGGTTACTCGTTGCGGCCC -> GGTTACTCGTTGCGGCCCC
GCTATAGAATTTAAGACTT -> CTATAGAATTTAAGACTTA
CTATAGAATTTAAGACTTA -> TATAGAATTTAAGACTTAG
ATATGTTGGGATGGGTGTC -> TATGTTGGGATGGGTGTCT
TATGTTGGGATGGGTGTCT -> ATGTTGGGATGGGTGTCTC
GTGGGTAGACAGGCGTAAA -> TGGGTAGACAGGCGTAAAA
CACTGCCCTGTAGAGGAGA -> ACTGCCCTGTAGAGGAGAA
ACTGCCCTGTAGAGGAGAA -> CTGCCCTGTAGAGGAGAAA
GAAGGTTACTCGTTGCGGC -> AAGGTTACTCGTTGCGGCC
GGCTTCTAAATAGGATATG -> GCTTCTAAATAGGATATGG
GCTTCTAAATAGGATATGG -> CTTCTAAATAGGATATGGT
AAGCCATATGTCGAATGAG -> AGCCATATGTCGAATGAGA
CGTCAGTCACACTATAATG -> GTCAGTCACACTATAATGT
CCGTAGGTATGCATCCCCT -> CGTAGGTATGCATCCCCTC
CGTAGGTATGCATCCCCTC -> GTAGGTATGCATCCCCTCT
GCATACTAATTTCCTCTGG -> CATACTAATTTCCTCTGGG
GGCCAGTAATGTACGTAGA -> GCCAGTAATGTACGTAGAG
GCCAGTAATGTACGTAGAG -> CCAGTAATGTACGTAGAGG
CAAACACTTGTCCTTTCAA -> AAACACTTGTCCTTTCAAC
AAACACTTGTCCTTTCAAC -> AACACTTGTCCTTTCAACG
TCTTGTCTCGTGAGGGTCA -> CTTGTCTCGTGAGGGTCAT
CTTGTCTCGTGAGGGTCAT -> TTGTCTCGTGAGGGTCATC
TGTTCTTGTCTCGTGAGGG -> GTTCTTGTCTCGTGAGGGT
TAGCGAAACCGAAGGTTGG -> AGCGAAACCGAAGGTTGGT
GGGAGAATTAACACTAGGG -> GGAGAATTAACACTAGGGT
GCACAAATCATATGGTAAC -> CACAAATCATATGGTAACA
GGTGAGCAATGCGAACCCT -> GTGAGCAATGCGAACCCTG
GGCTCTCCCCTGGTCCCGC -> GCTCTCCCCTGGTCCCGCT
TGACCGCGATACCATAATG -> GACCGCGATACCATAATGA
TCAATAACACTAAAGTGGC -> CAATAACACTAAAGTGGCA
TGAGAGGAGAATCCCGTCC -> GAGAGGAGAATCCCGTCCG
GGGCTTCCAAGGAGTAAAA -> GGCTTCCAAGGAGTAAAAC
ATATAGGGCTTTTATTTCC -> TATAGGGCTTTTATTTCCA
TATAGGGCTTTTATTTCCA -> ATAGGGCTTTTATTTCCAC
TGGAAGCCATATGTTGGGA -> GGAAGCCATATGTTGGGAT
GGAAGCCATATGTTGGGAT -> GAAGCCATATGTTGGGATG
AAGCCATATGTGCACTGTA -> AGCCATATGTGCACTGTAG
AGCCATATGTGCACTGTAG -> GCCATATGTGCACTGTAGC
CCGTGCCTCACCGCCAGAT -> CGTGCCTCACCGCCAGATC
AAGGCAGGCGCGCCTCGTA -> AGGCAGGCGCGCCTCGTAG
AGGCAGGCGCGCCTCGTAG -> GGCAGGCGCGCCTCGTAGA
GTAATTTAGTTTGCGCCGC -> TAATTTAGTTTGCGCCGCA
TAAGGTGAGGGCTCTCCCC -> AAGGTGAGGGCTCTCCCCT
TCTAGTTGGGTCTTGCACC -> CTAGTTGGGTCTTGCACCA
ATGATATTACTAACGCACG -> TGATATTACTAACGCACGC
TGATATTACTAACGCACGC -> GATATTACTAACGCACGCT
TGTGTCTTTTCTGTAAGAT -> GTGTCTTTTCTGTAAGATG
GTGTCTTTTCTGTAAGATG -> TGTCTTTTCTGTAAGATGT
AGGTATGCATCCCCTCTGT -> GGTATGCATCCCCTCTGTT
CCTGTAGAGGAGAAAGATA -> CTGTAGAGGAGAAAGATAC
CTGTAGAGGAGAAAGATAC -> TGTAGAGGAGAAAGATACA
TGTCTTTTCTGTAAGATGT -> GTCTTTTCTGTAAGATGTA
GCACTGCCCTGTAGAGGAG -> CACTGCCCTGTAGAGGAGA
CCACTCTCCGGGCGCAACA -> CACTCTCCGGGCGCAACAG
GGGCTCGCCTTAAGGAATT -> GGCTCGCCTTAAGGAATTT
GGCTCGCCTTAAGGAATTT -> GCTCGCCTTAAGGAATTTC
TGCGAACCCTGACTAGCGG -> GCGAACCCTGACTAGCGGC
CGTCTCATGGGGACTCCCT -> GTCTCATGGGGACTCCCTT
TTGTCCTTTCAACGTCTCG -> TGTCCTTTCAACGTCTCGT
TGTCCTTTCAACGTCTCGT -> GTCCTTTCAACGTCTCGTA
GTAAACCTGCGGAACTAGC -> TAAACCTGCGGAACTAGCC
ACTACACTCCTTCGTGGAA -> CTACACTCCTTCGTGGAAA
CAGTTCTCCCAACAAAGTG -> AGTTCTCCCAACAAAGTGT
CCCACCGCGAGATAGGGGG -> CCACCGCGAGATAGGGGGA
GTAAGCTTACAAGAGTCAG -> TAAGCTTACAAGAGTCAGC
TGCCCGTGGACACGCTCAG -> GCCCGTGGACACGCTCAGA
GCCCGTGGACACGCTCAGA -> CCCGTGGACACGCTCAGAC
ATACACGAGTCAAGTACGT -> TACACGAGTCAAGTACGTG
CGCCTTAAGGAATTTCCGT -> GCCTTAAGGAATTTCCGTA
GGTCGATCAATAACACTAA -> GTCGATCAATAACACTAAA
GATAACTTTTCCCGTCCGT -> ATAACTTTTCCCGTCCGTC
CTTGAGTCCGCGGAAATCA -> TTGAGTCCGCGGAAATCAT
TTGAGTCCGCGGAAATCAT -> TGAGTCCGCGGAAATCATG
AGAGGTGAGCAATGCGAAC -> GAGGTGAGCAATGCGAACC
GACTAGAGCGTAATACCCC -> ACTAGAGCGTAATACCCCA
CCAACATTGAAGGTCTTAT -> CAACATTGAAGGTCTTATA
CAACATTGAAGGTCTTATA -> AACATTGAAGGTCTTATAT
TTGGAAGCCATATGTTGGG -> TGGAAGCCATATGTTGGGA
AACACTTGTCCTTTCAACG -> ACACTTGTCCTTTCAACGT
CATTAAACGGGCCAGTAAT -> ATTAAACGGGCCAGTAATG
GCGCGCGTGGCCGCGCTCT -> CGCGCGTGGCCGCGCTCTC
GCCGTAGGTATGCATCCCC -> CCGTAGGTATGCATCCCCT
GTTATATGGAAACTACACT -> TTATATGGAAACTACACTC
TGACAGGCACTGCCCTGTA -> GACAGGCACTGCCCTGTAG
AGAGTACTAAGAATTCAGC -> GAGTACTAAGAATTCAGCG
ATTTAAGACTTAGGGCTTC -> TTTAAGACTTAGGGCTTCC
GTAGAGCTATATAGGGCTT -> TAGAGCTATATAGGGCTTT
GCGTTGGCGCCGCACGGCT -> CGTTGGCGCCGCACGGCTT
AGGGAAGGTTACTCGTTGC -> GGGAAGGTTACTCGTTGCG
ATGGCAACTCTCGTGAAAG -> TGGCAACTCTCGTGAAAGC
TCTGGACTGACAGGCACTG -> CTGGACTGACAGGCACTGC
GAAGCCATATGTTGGGATG -> AAGCCATATGTTGGGATGG
AAGCCATATGTTGGGATGG -> AGCCATATGTTGGGATGGG
CTCCCAACAAAGTGTTAGC -> TCCCAACAAAGTGTTAGCC
TCCCAACAAAGTGTTAGCC -> CCCAACAAAGTGTTAGCCC
GCGTTGATTTACAGTTCTC -> CGTTGATTTACAGTTCTCC
ATCCGGTAACCCGAGACTA -> TCCGGTAACCCGAGACTAG
GGAGAAAGATACATAACGG -> GAGAAAGATACATAACGGG
GACGAGGGAAGGTTACTCG -> ACGAGGGAAGGTTACTCGT
ACGAGGGAAGGTTACTCGT -> CGAGGGAAGGTTACTCGTT
GCTCTAGGGGGTTTTTCAC -> CTCTAGGGGGTTTTTCACG
CTACTACGGCAGGAAACAT -> TACTACGGCAGGAAACATG
CCCCTCGAGAGGACGTCTC -> CCCTCGAGAGGACGTCTCA
CCCTCGAGAGGACGTCTCA -> CCTCGAGAGGACGTCTCAT
GAATTCAGCGCGCGTGGCC -> AATTCAGCGCGCGTGGCCG
TATGTAAACCTGCGGAACT -> ATGTAAACCTGCGGAACTA
TTCCACAGAGGCTGGTCGA -> TCCACAGAGGCTGGTCGAT
CTAAGGTGAGGGCTCTCCC -> TAAGGTGAGGGCTCTCCCC
ACCGTGACCCTCACCTGAG -> CCGTGACCCTCACCTGAGC
CCGTGACCCTCACCTGAGC -> CGTGACCCTCACCTGAGCA
TTACAAGAGTCAGCGGCCC -> TACAAGAGTCAGCGGCCCC
TTAGTTGGTCATTCCTGTC -> TAGTTGGTCATTCCTGTCG
TTAGCCCAACGAGCCGGCC -> TAGCCCAACGAGCCGGCCC
GGAAACTACACTCCTTCGT -> GAAACTACACTCCTTCGTG
GTGCTGATGATCCGGTAAC -> TGCTGATGATCCGGTAACC
GTTCTGCCCGAGATGTGCA -> TTCTGCCCGAGATGTGCAC
TTCTGCCCGAGATGTGCAC -> TCTGCCCGAGATGTGCACC
GAAGCCATATGTGCACTGT -> AAGCCATATGTGCACTGTA
AGACAGGCGTAAAATGATA -> GACAGGCGTAAAATGATAT
GACAGGCGTAAAATGATAT -> ACAGGCGTAAAATGATATT
CGCGTGGTGACCGCGATAC -> GCGTGGTGACCGCGATACC
GCGTGGTGACCGCGATACC -> CGTGGTGACCGCGATACCA
TCATATGGTAACACTAATT -> CATATGGTAACACTAATTT
CATATGGTAACACTAATTT -> ATATGGTAACACTAATTTA
GTAAAAGTTCAGCAGTTGT -> TAAAAGTTCAGCAGTTGTT
TAAAAGTTCAGCAGTTGTT -> AAAAGTTCAGCAGTTGTTC
TAACGCACGCTCTTTTGTG -> AACGCACGCTCTTTTGTGT
AACGCACGCTCTTTTGTGT -> ACGCACGCTCTTTTGTGTT
GACGGCTTCTAAGGTGAGG -> ACGGCTTCTAAGGTGAGGG
TAATTAGCCCAACGAGCCG -> AATTAGCCCAACGAGCCGG
GACCGCGATACCATAATGA -> ACCGCGATACCATAATGAT
CATGCAAGCTATAGAACGT -> ATGCAAGCTATAGAACGTT
CTGCCATGTTGTGGGCAAG -> TGCCATGTTGTGGGCAAGA
AACCTAACGCGTGGTGACC -> ACCTAACGCGTGGTGACCG
ACCTAACGCGTGGTGACCG -> CCTAACGCGTGGTGACCGC
GCAGACCACTCTCCGGGCG -> CAGACCACTCTCCGGGCGC
AGCAATGCGAACCCTGACT -> GCAATGCGAACCCTGACTA
GCAATGCGAACCCTGACTA -> CAATGCGAACCCTGACTAG
TCGTAAACCTAACGCGTGG -> CGTAAACCTAACGCGTGGT
CGTAAACCTAACGCGTGGT -> GTAAACCTAACGCGTGGTG
TGGCCTCGGGGGACGAAGG -> GGCCTCGGGGGACGAAGGC
GCGCTATAGAATTTAAGAC -> CGCTATAGAATTTAAGACT
CGCTATAGAATTTAAGACT -> GCTATAGAATTTAAGACTT
CCGGCTTTGACACGGGTAC -> CGGCTTTGACACGGGTACT
TCCCTAGTAAAAGTTCAGC -> CCCTAGTAAAAGTTCAGCA
CCCTAGTAAAAGTTCAGCA -> CCTAGTAAAAGTTCAGCAG
CGGCCCCCTCTGGACTGAC -> GGCCCCCTCTGGACTGACA
AGCGAAACCGAAGGTTGGT -> GCGAAACCGAAGGTTGGTA
CTCAAAGTAGAGCTATATA -> TCAAAGTAGAGCTATATAG
CAGACCACTCTCCGGGCGC -> AGACCACTCTCCGGGCGCA
GAGCGCAGTCCAACATTGA -> AGCGCAGTCCAACATTGAA
TATAGAATTTAAGACTTAG -> ATAGAATTTAAGACTTAGG
CTGGGACTGGCGTTGAGCC -> TGGGACTGGCGTTGAGCCG
TGGGACTGGCGTTGAGCCG -> GGGACTGGCGTTGAGCCGT
TTCGTGGAAACAGCTCCAC -> TCGTGGAAACAGCTCCACA
TTTAAGACTTAGGGCTTCC -> TTAAGACTTAGGGCTTCCA
CCGTAAATACAGAATAAGC -> CGTAAATACAGAATAAGCC
TCCCACCCTTGAGTCCGCG -> CCCACCCTTGAGTCCGCGG
TTTTATTTCCACAGAGGCT -> TTTATTTCCACAGAGGCTG
ATGCAAGCTATAGAACGTT -> TGCAAGCTATAGAACGTTT
TCGTAAACTGATTCTAGCC -> CGTAAACTGATTCTAGCCA
GGTTGGTATTTAGCCCGTA -> GTTGGTATTTAGCCCGTAG
GACTGACAGGCACTGCCCT -> ACTGACAGGCACTGCCCTG
AGCCATATGTTGGGATGGG -> GCCATATGTTGGGATGGGT
TCACGCTCTCGTCACCACC -> CACGCTCTCGTCACCACCC
CACGCTCTCGTCACCACCC -> ACGCTCTCGTCACCACCCG
CTAAGAATTCAGCGCGCGT -> TAAGAATTCAGCGCGCGTG
CTGTAGCGCGAAACCCAGA -> TGTAGCGCGAAACCCAGAC
TGTAGATATAGCGAAACCG -> GTAGATATAGCGAAACCGA
AAGTACGTGGGTAGACAGG -> AGTACGTGGGTAGACAGGC
AGTACGTGGGTAGACAGGC -> GTACGTGGGTAGACAGGCG
GATGTGCACCGTGACCCTC -> ATGTGCACCGTGACCCTCA
AACGGGCCAGTAATGTACG -> ACGGGCCAGTAATGTACGT
CGGCAAACACTTGTCCTTT -> GGCAAACACTTGTCCTTTC
TAACGGGCTGTGAGCGCAG -> AACGGGCTGTGAGCGCAGT
GAAACCGAAGGTTGGTATT -> AAACCGAAGGTTGGTATTT
AAACCGAAGGTTGGTATTT -> AACCGAAGGTTGGTATTTA
CTTAGCGACCAGTAGCGAG -> TTAGCGACCAGTAGCGAGC
TTAGCGACCAGTAGCGAGC -> TAGCGACCAGTAGCGAGCG
GCCCCCGCGCAATGGGACG -> CCCCCGCGCAATGGGACGA
CCCCCGCGCAATGGGACGA -> CCCCGCGCAATGGGACGAT
GTTGGTATTTAGCCCGTAG -> TTGGTATTTAGCCCGTAGC
TTGGTATTTAGCCCGTAGC -> TGGTATTTAGCCCGTAGCG
ATAAGCCTTCATACACGAG -> TAAGCCTTCATACACGAGT
CCTTCGCATACTAATTTCC -> CTTCGCATACTAATTTCCT
GGAAACATGCCATGACAGA -> GAAACATGCCATGACAGAA
CGAGGGAAGGTTACTCGTT -> GAGGGAAGGTTACTCGTTG
CCTTGAGTCCGCGGAAATC -> CTTGAGTCCGCGGAAATCA
ACTTAGGGCTTCCAAGGAG -> CTTAGGGCTTCCAAGGAGT
GCTGCCATGTTGTGGGCAA -> CTGCCATGTTGTGGGCAAG
GAATTAACACTAGGGTAAC -> AATTAACACTAGGGTAACC
GGTCCCGCTCGGCACGAGT -> GTCCCGCTCGGCACGAGTT
CATGCCATGACAGAACGCG -> ATGCCATGACAGAACGCGG
ATGCCATGACAGAACGCGG -> TGCCATGACAGAACGCGGA
TCGGCTCTTTAGTTGTAGA -> CGGCTCTTTAGTTGTAGAT
CGGCTCTTTAGTTGTAGAT -> GGCTCTTTAGTTGTAGATA
CAGTCCAACATTGAAGGTC -> AGTCCAACATTGAAGGTCT
TGCTGCGACTTGATGCTCT -> GCTGCGACTTGATGCTCTA
CGTTGAGCCGTAGGTATGC -> GTTGAGCCGTAGGTATGCA
GCCCAAAAAGTAGTGCGTT -> CCCAAAAAGTAGTGCGTTC
TAATTAAAATTGGAGCATT -> AATTAAAATTGGAGCATTT
GCCTCGTAGATGCCATACC -> CCTCGTAGATGCCATACCG
GACTCGTGAGTTGTTGTGC -> ACTCGTGAGTTGTTGTGCT
TCCGGTAACCCGAGACTAG -> CCGGTAACCCGAGACTAGA
AGGGTAACCAAACGGTCTT -> GGGTAACCAAACGGTCTTG
GGGTAACCAAACGGTCTTG -> GGTAACCAAACGGTCTTGG
GCGCCGCACGGCTTCTAAA -> CGCCGCACGGCTTCTAAAT
ACACGCTCAGACATGACAC -> CACGCTCAGACATGACACG
CACGCTCAGACATGACACG -> ACGCTCAGACATGACACGA
GTCACCACCCGTGCCTCAC -> TCACCACCCGTGCCTCACC
ACCGCGATACCATAATGAT -> CCGCGATACCATAATGATT
GGAAGCCATATGTAAACCT -> GAAGCCATATGTAAACCTG
TTCAGGGCCCAAAAAGTAG -> TCAGGGCCCAAAAAGTAGT
CGATCAATAACACTAAAGT -> GATCAATAACACTAAAGTG
CCATTTAGCCCAACGAGCC -> CATTTAGCCCAACGAGCCG
ACGCACGCTCTTTTGTGTT -> CGCACGCTCTTTTGTGTTT
ACCAGTTGCGTTGCTCTAG -> CCAGTTGCGTTGCTCTAGG
GATGCCATACCGTAAATAC -> ATGCCATACCGTAAATACA
TTTACAGTTCTCCCAACAA -> TTACAGTTCTCCCAACAAA
GACATGACACGAAGACCAG -> ACATGACACGAAGACCAGT
AGTCCAACATTGAAGGTCT -> GTCCAACATTGAAGGTCTT
GCGGCATCTACATAATGAC -> CGGCATCTACATAATGACG
CGGCATCTACATAATGACG -> GGCATCTACATAATGACGG
GAAACATGCCATGACAGAA -> AAACATGCCATGACAGAAC
TAAACCTAACGCGTGGTGA -> AAACCTAACGCGTGGTGAC
AAACCTAACGCGTGGTGAC -> AACCTAACGCGTGGTGACC
GGTCATTCCTGTCGCTGCC -> GTCATTCCTGTCGCTGCCA
TTTTCACGCTCTCGTCACC -> TTTCACGCTCTCGTCACCA
TGTAGCGCGCTCCCGCGGC -> GTAGCGCGCTCCCGCGGCA
TCTTATATATAATTAAAAT -> CTTATATATAATTAAAATT
TTTCCAGGCCCGAAATGTC -> TTCCAGGCCCGAAATGTCA
CGTAATACCCCACTTCGGC -> GTAATACCCCACTTCGGCA
GTAATACCCCACTTCGGCA -> TAATACCCCACTTCGGCAA
ACCCTTGAGTCCGCGGAAA -> CCCTTGAGTCCGCGGAAAT
CATCTACATAATGACGGCT -> ATCTACATAATGACGGCTT
ATCTACATAATGACGGCTT -> TCTACATAATGACGGCTTC
CACACTGTCTAATTAGCCC -> ACACTGTCTAATTAGCCCA
ACACTGTCTAATTAGCCCA -> CACTGTCTAATTAGCCCAA
CCCTCTGGACTGACAGGCA -> CCTCTGGACTGACAGGCAC
CCTCTGGACTGACAGGCAC -> CTCTGGACTGACAGGCACT
ACTAGCGGCAACGGGGAGA -> CTAGCGGCAACGGGGAGAA
GGGTGTCTCGGCATTCCGG -> GGTGTCTCGGCATTCCGGG
GGTGTCTCGGCATTCCGGG -> GTGTCTCGGCATTCCGGGA
GACGATGCTGCCATGTTGT -> ACGATGCTGCCATGTTGTG
ACGATGCTGCCATGTTGTG -> CGATGCTGCCATGTTGTGG
AAGTTCAGCAGTTGTTCGT -> AGTTCAGCAGTTGTTCGTA
AGTTCAGCAGTTGTTCGTA -> GTTCAGCAGTTGTTCGTAA
AATTTCCGTAATCTGTGTA -> ATTTCCGTAATCTGTGTAG
GGAGAATTAACACTAGGGT -> GAGAATTAACACTAGGGTA
GAGGGAAGGTTACTCGTTG -> AGGGAAGGTTACTCGTTGC
TTACTACTGAGCGATGGGA -> TACTACTGAGCGATGGGAC
CACGGAATCTCTGATCCCA -> ACGGAATCTCTGATCCCAC
ATCCCCTCTGTTCTTGTCT -> TCCCCTCTGTTCTTGTCTC
CAAATCATATGGTAACACT -> AAATCATATGGTAACACTA
GTCCAACATTGAAGGTCTT -> TCCAACATTGAAGGTCTTA
CAGACATGACACGAAGACC -> AGACATGACACGAAGACCA
AGACATGACACGAAGACCA -> GACATGACACGAAGACCAG
GGCTGTGAGCGCAGTCCAA -> GCTGTGAGCGCAGTCCAAC
GTAGCGTGCTCAAAGTAGA -> TAGCGTGCTCAAAGTAGAG
TAGCGTGCTCAAAGTAGAG -> AGCGTGCTCAAAGTAGAGC
ATTGGAGCATTTTAGTTGG -> TTGGAGCATTTTAGTTGGT
AGGAGAAAGATACATAACG -> GGAGAAAGATACATAACGG
GTTGGGATGGGTGTCTCGG -> TTGGGATGGGTGTCTCGGC
CCATTAAACGGGCCAGTAA -> CATTAAACGGGCCAGTAAT
GTTGCTCTAGGGGGTTTTT -> TTGCTCTAGGGGGTTTTTC
TATATGGAAACTACACTCC -> ATATGGAAACTACACTCCT
ATATGGAAACTACACTCCT -> TATGGAAACTACACTCCTT
AACCCTGACTAGCGGCAAC -> ACCCTGACTAGCGGCAACG
ACCCTGACTAGCGGCAACG -> CCCTGACTAGCGGCAACGG
CGCACGCTCTTTTGTGTTT -> GCACGCTCTTTTGTGTTTC
GAGTTAAGCACAAGAGTAC -> AGTTAAGCACAAGAGTACT
TGTTCGTAAACTGATTCTA -> GTTCGTAAACTGATTCTAG
GCCCGTAGCGTGCTCAAAG -> CCCGTAGCGTGCTCAAAGT
CTTAGCCCAACGAGCCGGC -> TTAGCCCAACGAGCCGGCC
ATGCCATACCGTAAATACA -> TGCCATACCGTAAATACAG
CTTCATTCTAGTTGGGTCT -> TTCATTCTAGTTGGGTCTT
TAGTAAAAGTTCAGCAGTT -> AGTAAAAGTTCAGCAGTTG
AGTAAAAGTTCAGCAGTTG -> GTAAAAGTTCAGCAGTTGT
GTCCTCACATCCCTAGTAA -> TCCTCACATCCCTAGTAAA
ATTTGATACTTTGGAAGCC -> TTTGATACTTTGGAAGCCA
ACCGTAAATACAGAATAAG -> CCGTAAATACAGAATAAGC
GAAGCCATATGTAAACCTG -> AAGCCATATGTAAACCTGC
AAGCCATATGTAAACCTGC -> AGCCATATGTAAACCTGCG
ACCAGTAGCGAGCGCATGG -> CCAGTAGCGAGCGCATGGC
TTTAGCCCGTAGCGTGCTC -> TTAGCCCGTAGCGTGCTCA
TGGAGCACGGAATCTCTGA -> GGAGCACGGAATCTCTGAT
CGCGGCATCTACATAATGA -> GCGGCATCTACATAATGAC
GCCGGCAATGTATTTGATA -> CCGGCAATGTATTTGATAC
AGGCTGGTCGATCAATAAC -> GGCTGGTCGATCAATAACA
GGCTGGTCGATCAATAACA -> GCTGGTCGATCAATAACAC
AATTCAGCGCGCGTGGCCG -> ATTCAGCGCGCGTGGCCGC
CCTCGTAGATGCCATACCG -> CTCGTAGATGCCATACCGT
CCTAGTAAAAGTTCAGCAG -> CTAGTAAAAGTTCAGCAGT
CTAGTAAAAGTTCAGCAGT -> TAGTAAAAGTTCAGCAGTT
TAAAATGATATTACTAACG -> AAAATGATATTACTAACGC
AGCCCAACGAGCCGGCAAT -> GCCCAACGAGCCGGCAATG
GCCCAACGAGCCGGCAATG -> CCCAACGAGCCGGCAATGT
TCACCACCCGTGCCTCACC -> CACCACCCGTGCCTCACCG
TTGGCAGACCACTCTCCGG -> TGGCAGACCACTCTCCGGG
CCCTCTGTTCTTGTCTCGT -> CCTCTGTTCTTGTCTCGTG
AACTACACTCCTTCGTGGA -> ACTACACTCCTTCGTGGAA
AGTAGTGCGTTCTGCCCGA -> GTAGTGCGTTCTGCCCGAG
GTAGTGCGTTCTGCCCGAG -> TAGTGCGTTCTGCCCGAGA
TTGTGCTGATGATCCGGTA -> TGTGCTGATGATCCGGTAA
TGTGCTGATGATCCGGTAA -> GTGCTGATGATCCGGTAAC
TAGAGGAGAAAGATACATA -> AGAGGAGAAAGATACATAA
GTCCGCGGAAATCATGCAA -> TCCGCGGAAATCATGCAAG
GTTGTGCTGATGATCCGGT -> TTGTGCTGATGATCCGGTA
TGGTATTTAGCCCGTAGCG -> GGTATTTAGCCCGTAGCGT
AAGACCAGTTGCGTTGCTC -> AGACCAGTTGCGTTGCTCT
GACAGGCACTGCCCTGTAG -> ACAGGCACTGCCCTGTAGA
TCAGGGCCCAAAAAGTAGT -> CAGGGCCCAAAAAGTAGTG
ACAGGCACTGCCCTGTAGA -> CAGGCACTGCCCTGTAGAG
CAGGCACTGCCCTGTAGAG -> AGGCACTGCCCTGTAGAGG
CCCGTCCGTCGTAATTTAG -> CCGTCCGTCGTAATTTAGT
CCGTCCGTCGTAATTTAGT -> CGTCCGTCGTAATTTAGTT
CGTTGGCGCCGCACGGCTT -> GTTGGCGCCGCACGGCTTC
GGCCCCCGCGCAATGGGAC -> GCCCCCGCGCAATGGGACG
TCTACATAATGACGGCTTC -> CTACATAATGACGGCTTCT
TACGGCAGGAAACATGCCA -> ACGGCAGGAAACATGCCAT
ACGGCAGGAAACATGCCAT -> CGGCAGGAAACATGCCATG
ATATGGTAACACTAATTTA -> TATGGTAACACTAATTTAT
GACTTGATGCTCTACTACG -> ACTTGATGCTCTACTACGG
CACCTGAGCAATCGGCTCT -> ACCTGAGCAATCGGCTCTT
TTCCTGTCGCTGCCAGGGC -> TCCTGTCGCTGCCAGGGCT
CAGATCGTCATGGAGCACG -> AGATCGTCATGGAGCACGG
CGAGCCGGCGATCATTCAG -> GAGCCGGCGATCATTCAGC
GAGCCGGCGATCATTCAGC -> AGCCGGCGATCATTCAGCT
GAAATCATGCAAGCTATAG -> AAATCATGCAAGCTATAGA
AGGATATGGTGAACTGAGT -> GGATATGGTGAACTGAGTT
TATTTAGCCCGTAGCGTGC -> ATTTAGCCCGTAGCGTGCT
TAGAGCGTAATACCCCACT -> AGAGCGTAATACCCCACTT
GCACCATTTAGCCCAACGA -> CACCATTTAGCCCAACGAG
TGGTCGATCAATAACACTA -> GGTCGATCAATAACACTAA
GCCATATGTGCACTGTAGC -> CCATATGTGCACTGTAGCG
ATGTATTTGATACTTTGGA -> TGTATTTGATACTTTGGAA
CAAGTACGTGGGTAGACAG -> AAGTACGTGGGTAGACAGG
GCTACTTTGGAAGCCATAT -> CTACTTTGGAAGCCATATG
GTAAACCTAACGCGTGGTG -> TAAACCTAACGCGTGGTGA
TGGTAACACTAATTTATAT -> GGTAACACTAATTTATATA
ACATGCCATGACAGAACGC -> CATGCCATGACAGAACGCG
AAAAGTAGTGCGTTCTGCC -> AAAGTAGTGCGTTCTGCCC
AAACCCAGACCATAGTATG -> AACCCAGACCATAGTATGC
AAATCATATGGTAACACTA -> AATCATATGGTAACACTAA
TATGATAAATCCCCTCGAG -> ATGATAAATCCCCTCGAGA
GGGTACTTTGGAAGCCATA -> GGTACTTTGGAAGCCATAT
TAGTTGTAGATATAGCGAA -> AGTTGTAGATATAGCGAAA
CCAGGGCTCGCCTTAAGGA -> CAGGGCTCGCCTTAAGGAA
CAGGGCTCGCCTTAAGGAA -> AGGGCTCGCCTTAAGGAAT
ACGAGTTAAGCACAAGAGT -> CGAGTTAAGCACAAGAGTA
TCCAACATTGAAGGTCTTA -> CCAACATTGAAGGTCTTAT
CGTCCGTCGTAATTTAGTT -> GTCCGTCGTAATTTAGTTT
GTCCGTCGTAATTTAGTTT -> TCCGTCGTAATTTAGTTTG
TTTCAACGTCTCGTAAATG -> TTCAACGTCTCGTAAATGG
ATTTAGCCCGTAGCGTGCT -> TTTAGCCCGTAGCGTGCTC
ATGGGTGTCTCGGCATTCC -> TGGGTGTCTCGGCATTCCG
AAAATGATATTACTAACGC -> AAATGATATTACTAACGCA
GGACACGCTCAGACATGAC -> GACACGCTCAGACATGACA
ACAGTTGTCACACCGTTTC -> CAGTTGTCACACCGTTTCC
GTACGTGGGTAGACAGGCG -> TACGTGGGTAGACAGGCGT
TGTATTTGATACTTTGGAA -> GTATTTGATACTTTGGAAG
AGTTTGCGCCGCAATTATG -> GTTTGCGCCGCAATTATGA
GGCCCCCTCTGGACTGACA -> GCCCCCTCTGGACTGACAG
GCCCCCTCTGGACTGACAG -> CCCCCTCTGGACTGACAGG
AGCGCTATAGAATTTAAGA -> GCGCTATAGAATTTAAGAC
CTCACATCCCTAGTAAAAG -> TCACATCCCTAGTAAAAGT
GACACGGGTACTTTGGAAG -> ACACGGGTACTTTGGAAGC
CTCTGGACTGACAGGCACT -> TCTGGACTGACAGGCACTG
TCGGGGGACGAAGGCAGGC -> CGGGGGACGAAGGCAGGCG
CTCTCCCCTGGTCCCGCTC -> TCTCCCCTGGTCCCGCTCG
TAGCCCAACGAGCCGGCAA -> AGCCCAACGAGCCGGCAAT
GAGGTGAGCAATGCGAACC -> AGGTGAGCAATGCGAACCC
AGGTGAGCAATGCGAACCC -> GGTGAGCAATGCGAACCCT
GCGATACCATAATGATTCC -> CGATACCATAATGATTCCC
AATGTCATCGTGGTCCTCA -> ATGTCATCGTGGTCCTCAC
CCCTTGAGTCCGCGGAAAT -> CCTTGAGTCCGCGGAAATC
ACGCTCAGACATGACACGA -> CGCTCAGACATGACACGAA
CTGCCCTGTAGAGGAGAAA -> TGCCCTGTAGAGGAGAAAG
CCCTTCGCATACTAATTTC -> CCTTCGCATACTAATTTCC
ACCCGAGACTAGAGCGTAA -> CCCGAGACTAGAGCGTAAT
CACTTCGGCAAACACTTGT -> ACTTCGGCAAACACTTGTC
TGGTCCTCACATCCCTAGT -> GGTCCTCACATCCCTAGTA
GAAGGTTGGTATTTAGCCC -> AAGGTTGGTATTTAGCCCG
CAACGTCTCGTAAATGGTT -> AACGTCTCGTAAATGGTTT
TAGCGCGAAACCCAGACCA -> AGCGCGAAACCCAGACCAT
TAGGATATGGTGAACTGAG -> AGGATATGGTGAACTGAGT
TTTATTTCCACAGAGGCTG -> TTATTTCCACAGAGGCTGG
ACGGGCTGTGAGCGCAGTC -> CGGGCTGTGAGCGCAGTCC
TGGGTGTCTCGGCATTCCG -> GGGTGTCTCGGCATTCCGG
AATGACGGCTTCTAAGGTG -> ATGACGGCTTCTAAGGTGA
ATTTAGCCCAACGAGCCGG -> TTTAGCCCAACGAGCCGGC
TACTGAGCGATGGGACAGC -> ACTGAGCGATGGGACAGCC
CCGACGAGGGAAGGTTACT -> CGACGAGGGAAGGTTACTC
TTTCCACAGAGGCTGGTCG -> TTCCACAGAGGCTGGTCGA
TTCCAGGCCCGAAATGTCA -> TCCAGGCCCGAAATGTCAT
ATAGGGGGACTTGCTTTAG -> TAGGGGGACTTGCTTTAGA
CCAGTTGCGTTGCTCTAGG -> CAGTTGCGTTGCTCTAGGG
CAGTTGCGTTGCTCTAGGG -> AGTTGCGTTGCTCTAGGGG
TTGTGGGCAAGACTGATTG -> TGTGGGCAAGACTGATTGG
TACGTAGAGGTGAGCAATG -> ACGTAGAGGTGAGCAATGC
TCCCGCGGCATCTACATAA -> CCCGCGGCATCTACATAAT
GTAGATGCCATACCGTAAA -> TAGATGCCATACCGTAAAT
ACGAGCCGGCTTTGACACG -> CGAGCCGGCTTTGACACGG
CGAGCCGGCTTTGACACGG -> GAGCCGGCTTTGACACGGG
CATTTAGCCCAACGAGCCG -> ATTTAGCCCAACGAGCCGG
AACGAGCCGGCAATGTATT -> ACGAGCCGGCAATGTATTT
GACACGAAGACCAGTTGCG -> ACACGAAGACCAGTTGCGT
ACACGAAGACCAGTTGCGT -> CACGAAGACCAGTTGCGTT
GTTGGTCATTCCTGTCGCT -> TTGGTCATTCCTGTCGCTG
CAATCGGCTCTTTAGTTGT -> AATCGGCTCTTTAGTTGTA
TAGTTTGCGCCGCAATTAT -> AGTTTGCGCCGCAATTATG
CGATACCATAATGATTCCC -> GATACCATAATGATTCCCC
AACACTAATTTATATATCC -> ACACTAATTTATATATCCA
CGACGAGGGAAGGTTACTC -> GACGAGGGAAGGTTACTCG
TTATTTCCACAGAGGCTGG -> TATTTCCACAGAGGCTGGT
CAAGACTGATTGGCCTCGG -> AAGACTGATTGGCCTCGGG
GAGCCGGCTTTGACACGGG -> AGCCGGCTTTGACACGGGT
ACGTCTCATGGGGACTCCC -> CGTCTCATGGGGACTCCCT
CTTTGATAACTTTTCCCGT -> TTTGATAACTTTTCCCGTC
GCCAGGGCTCGCCTTAAGG -> CCAGGGCTCGCCTTAAGGA
GACGAAGGCAGGCGCGCCT -> ACGAAGGCAGGCGCGCCTC
CGTAGATGCCATACCGTAA -> GTAGATGCCATACCGTAAA
GTTACTACTGAGCGATGGG -> TTACTACTGAGCGATGGGA
GTGTCTCGGCATTCCGGGA -> TGTCTCGGCATTCCGGGAG
TGTTGTGCTGATGATCCGG -> GTTGTGCTGATGATCCGGT
CCCTGTAGAGGAGAAAGAT -> CCTGTAGAGGAGAAAGATA
TCGTGGTCCTCACATCCCT -> CGTGGTCCTCACATCCCTA
ATCGTAAACCTAACGCGTG -> TCGTAAACCTAACGCGTGG
AGCCGGCGATCATTCAGCT -> GCCGGCGATCATTCAGCTA
GAGTCAGCGGCCCCCGCGC -> AGTCAGCGGCCCCCGCGCA
AGTCAGCGGCCCCCGCGCA -> GTCAGCGGCCCCCGCGCAA
TGCACCATTTAGCCCAACG -> GCACCATTTAGCCCAACGA
GTCTCGTAAATGGTTTAGC -> TCTCGTAAATGGTTTAGCG
CAAGAGTACTAAGAATTCA -> AAGAGTACTAAGAATTCAG
GAAAGATACATAACGGGCT -> AAAGATACATAACGGGCTG
TTATATGGAAACTACACTC -> TATATGGAAACTACACTCC
CCAAACGGTCTTGGCAGAC -> CAAACGGTCTTGGCAGACC
CGTGGACACGCTCAGACAT -> GTGGACACGCTCAGACATG
ATAACTTTTCCCGTCCGTC -> TAACTTTTCCCGTCCGTCG
GACACGCTCAGACATGACA -> ACACGCTCAGACATGACAC
TACTAACGCACGCTCTTTT -> ACTAACGCACGCTCTTTTG
ACTAACGCACGCTCTTTTG -> CTAACGCACGCTCTTTTGT
GTCAGCGGCCCCCGCGCAA -> TCAGCGGCCCCCGCGCAAT
GGGGGTTTTTCACGCTCTC -> GGGGTTTTTCACGCTCTCG
GGGGTTTTTCACGCTCTCG -> GGGTTTTTCACGCTCTCGT
ATCCCTAGTAAAAGTTCAG -> TCCCTAGTAAAAGTTCAGC
CTAACGCACGCTCTTTTGT -> TAACGCACGCTCTTTTGTG
CCCCCTCTGGACTGACAGG -> CCCCTCTGGACTGACAGGC
AGAGGCTGGTCGATCAATA -> GAGGCTGGTCGATCAATAA
CGTTGCGGCCCCCTCTGGA -> GTTGCGGCCCCCTCTGGAC
GTTGCGGCCCCCTCTGGAC -> TTGCGGCCCCCTCTGGACT
GGGACTGGCGTTGAGCCGT -> GGACTGGCGTTGAGCCGTA
GGGGGACGAAGGCAGGCGC -> GGGGACGAAGGCAGGCGCG
GGGGACGAAGGCAGGCGCG -> GGGACGAAGGCAGGCGCGC
CGAACCCTGACTAGCGGCA -> GAACCCTGACTAGCGGCAA
GAACCCTGACTAGCGGCAA -> AACCCTGACTAGCGGCAAC
GAGGCTGGTCGATCAATAA -> AGGCTGGTCGATCAATAAC
TATTTCCACAGAGGCTGGT -> ATTTCCACAGAGGCTGGTC
ATTTCCACAGAGGCTGGTC -> TTTCCACAGAGGCTGGTCG
AATTGGAGCATTTTAGTTG -> ATTGGAGCATTTTAGTTGG
AACGTCTCGTAAATGGTTT -> ACGTCTCGTAAATGGTTTA
TAGTATGCTTATTCAAGCG -> AGTATGCTTATTCAAGCGA
TCGTGAGTTGTTGTGCTGA -> CGTGAGTTGTTGTGCTGAT
CCTCTGTTCTTGTCTCGTG -> CTCTGTTCTTGTCTCGTGA
CGAGAAAGGCTGTAAGCTT -> GAGAAAGGCTGTAAGCTTA
CCTCTGGGACTGGCGTTGA -> CTCTGGGACTGGCGTTGAG
AGGCGTAAAATGATATTAC -> GGCGTAAAATGATATTACT
GGCAAACACTTGTCCTTTC -> GCAAACACTTGTCCTTTCA
GCAAACACTTGTCCTTTCA -> CAAACACTTGTCCTTTCAA
AGTTACTACTGAGCGATGG -> GTTACTACTGAGCGATGGG
AAGAGTACTAAGAATTCAG -> AGAGTACTAAGAATTCAGC
CCCAACGAGCCGGCAATGT -> CCAACGAGCCGGCAATGTA
CCAACGAGCCGGCAATGTA -> CAACGAGCCGGCAATGTAT
TCTCGTGAGGGTCATCGCA -> CTCGTGAGGGTCATCGCAC
CCGATTCCCGGTACTTTGG -> CGATTCCCGGTACTTTGGA
GGAAATCATGCAAGCTATA -> GAAATCATGCAAGCTATAG
ATGGTTTAGCGAGCCCTTC -> TGGTTTAGCGAGCCCTTCC
CGATTCCCGGTACTTTGGA -> GATTCCCGGTACTTTGGAA
AACTGATTCTAGCCACGTC -> ACTGATTCTAGCCACGTCA
CTTAAGGAATTTCCGTAAT -> TTAAGGAATTTCCGTAATC
TGATTTACAGTTCTCCCAA -> GATTTACAGTTCTCCCAAC
GTTTTTCACGCTCTCGTCA -> TTTTTCACGCTCTCGTCAC
TTTTTCACGCTCTCGTCAC -> TTTTCACGCTCTCGTCACC
TATATAGGGCTTTTATTTC -> ATATAGGGCTTTTATTTCC
GCACCGTGACCCTCACCTG -> CACCGTGACCCTCACCTGA
AGCCCGTAGCGTGCTCAAA -> GCCCGTAGCGTGCTCAAAG
CCCTGACTAGCGGCAACGG -> CCTGACTAGCGGCAACGGG
TTCCTCTGGGACTGGCGTT -> TCCTCTGGGACTGGCGTTG
CTTTTGTGTTTCAACAGCG -> TTTTGTGTTTCAACAGCGT
GCTGCCAGGGCTCGCCTTA -> CTGCCAGGGCTCGCCTTAA
CTCTTTTGTGTTTCAACAG -> TCTTTTGTGTTTCAACAGC
TCTTTTGTGTTTCAACAGC -> CTTTTGTGTTTCAACAGCG
GCATTTTAGTTGGTCATTC -> CATTTTAGTTGGTCATTCC
CGCTGCCAGGGCTCGCCTT -> GCTGCCAGGGCTCGCCTTA
AACGGGCTGTGAGCGCAGT -> ACGGGCTGTGAGCGCAGTC
GCTCGCCTTAAGGAATTTC -> CTCGCCTTAAGGAATTTCC
CCCGGTACTTTGGAAGCCA -> CCGGTACTTTGGAAGCCAT
TACAAGAGTCAGCGGCCCC -> ACAAGAGTCAGCGGCCCCC
TCCTCTGGGACTGGCGTTG -> CCTCTGGGACTGGCGTTGA
CACCGTGACCCTCACCTGA -> ACCGTGACCCTCACCTGAG
AGCGGCCCCCGCGCAATGG -> GCGGCCCCCGCGCAATGGG
GAGGAGAAAGATACATAAC -> AGGAGAAAGATACATAACG
TTAAGCACAAGAGTACTAA -> TAAGCACAAGAGTACTAAG
ACTTGATGCTCTACTACGG -> CTTGATGCTCTACTACGGC
GGGTTTTTCACGCTCTCGT -> GGTTTTTCACGCTCTCGTC
TGACTAGCGGCAACGGGGA -> GACTAGCGGCAACGGGGAG
TGTCTCGGCATTCCGGGAG -> GTCTCGGCATTCCGGGAGC
GCGAACCCTGACTAGCGGC -> CGAACCCTGACTAGCGGCA
CAACGAGCCGGCAATGTAT -> AACGAGCCGGCAATGTATT
CCCCTCTGGACTGACAGGC -> CCCTCTGGACTGACAGGCA
GACTAGCGGCAACGGGGAG -> ACTAGCGGCAACGGGGAGA
CGGGGGACGAAGGCAGGCG -> GGGGGACGAAGGCAGGCGC
GGTCCTCACATCCCTAGTA -> GTCCTCACATCCCTAGTAA
AGCGAGCGCATGGCAACTC -> GCGAGCGCATGGCAACTCT
ACTACGGCAGGAAACATGC -> CTACGGCAGGAAACATGCC
CTACGGCAGGAAACATGCC -> TACGGCAGGAAACATGCCA
GGACGAAGGCAGGCGCGCC -> GACGAAGGCAGGCGCGCCT
CTTGATGCTCTACTACGGC -> TTGATGCTCTACTACGGCA
GGGACGAAGGCAGGCGCGC -> GGACGAAGGCAGGCGCGCC
GGTCTTGGCAGACCACTCT -> GTCTTGGCAGACCACTCTC
GGTTTTTCACGCTCTCGTC -> GTTTTTCACGCTCTCGTCA
CGAGTTAAGCACAAGAGTA -> GAGTTAAGCACAAGAGTAC
ACTTAGCCCAACGAGCCGG -> CTTAGCCCAACGAGCCGGC
CCTAACGCGTGGTGACCGC -> CTAACGCGTGGTGACCGCG
AGAGGAGAAAGATACATAA -> GAGGAGAAAGATACATAAC
AGCATTTTAGTTGGTCATT -> GCATTTTAGTTGGTCATTC
TTACTAACGCACGCTCTTT -> TACTAACGCACGCTCTTTT
GTTTAGCGAGCCCTTCCTT -> TTTAGCGAGCCCTTCCTTC
AATTTATATATCCATTAAA -> ATTTATATATCCATTAAAC
TGGTCCCGCTCGGCACGAG -> GGTCCCGCTCGGCACGAGT
TCCGGGAGCTACTGGTCGC -> CCGGGAGCTACTGGTCGCG
TTGCGGCCCCCTCTGGACT -> TGCGGCCCCCTCTGGACTG
TTCCGGGAGCTACTGGTCG -> TCCGGGAGCTACTGGTCGC
AGGGCTCGCCTTAAGGAAT -> GGGCTCGCCTTAAGGAATT
AGTCAAGTACGTGGGTAGA -> GTCAAGTACGTGGGTAGAC
ACGAGCCGGCCCGATTCCC -> CGAGCCGGCCCGATTCCCG
TACTACGGCAGGAAACATG -> ACTACGGCAGGAAACATGC
AGCAGGAAGCGCTATAGAA -> GCAGGAAGCGCTATAGAAT
GCTCTCCCCTGGTCCCGCT -> CTCTCCCCTGGTCCCGCTC